County,State,Total population,Median age,Total population 18 and over,Total population 65 years and over,Male population,Female population,Location 1
Autauga County,Alabama,54571,37,39958,6546,26569,28002,"(32.533470000000001, -86.649979999999999)"
Baldwin County,Alabama,182265,41.1,140367,30568,89196,93069,"(30.75047, -87.766660000000002)"
Barbour County,Alabama,27457,39,21442,3909,14576,12881,"(31.883489999999998, -85.449939999999998)"
Bibb County,Alabama,22915,37.799999999999997,17714,2906,12301,10614,"(33.000399999999999, -87.15)"
Blount County,Alabama,57322,39,43216,8439,28362,28960,"(33.966769999999997, -86.583320000000001)"
Bullock County,Alabama,10914,38.5,8484,1469,5912,5002,"(32.06682, -85.699950000000001)"
Butler County,Alabama,20947,40.1,15891,3489,9838,11109,"(31.829319999999999, -86.620810000000006)"
Calhoun County,Alabama,118572,38.200000000000003,91446,16990,57176,61396,"(33.75038, -85.849969999999999)"
Chambers County,Alabama,34215,41.5,26512,5706,16363,17852,"(32.883459999999999, -85.399950000000004)"
Cherokee County,Alabama,25989,43.9,20423,4651,12888,13101,"(34.183430000000001, -85.449960000000004)"
Chilton County,Alabama,43643,37.6,32683,5921,21608,22035,"(32.866790000000002, -86.683319999999995)"
Choctaw County,Alabama,13859,43.4,10718,2519,6688,7171,"(32.01681, -88.266689999999997)"
Clarke County,Alabama,25833,40.200000000000003,19444,4174,12214,13619,"(31.683489999999999, -87.8)"
Clay County,Alabama,13932,42,10788,2449,6833,7099,"(33.266779999999997, -85.849959999999996)"
Cleburne County,Alabama,14972,40.6,11421,2361,7453,7519,"(33.66677, -85.516620000000003)"
Coffee County,Alabama,49948,37.6,37864,7210,24684,25264,"(31.416830000000001, -86.000219999999999)"
Colbert County,Alabama,54428,41.8,42394,9463,26159,28269,"(34.683419999999998, -87.816699999999997)"
Conecuh County,Alabama,13228,43,10186,2362,6412,6816,"(31.466830000000002, -86.983310000000003)"
Coosa County,Alabama,11539,44.2,9169,1970,5727,5812,"(32.933459999999997, -86.249690000000001)"
Covington County,Alabama,37765,42.4,29242,6939,18288,19477,"(31.266839999999998, -86.449960000000004)"
Crenshaw County,Alabama,13906,40.700000000000003,10598,2210,6714,7192,"(31.73349, -86.316630000000004)"
Cullman County,Alabama,80406,39.9,61765,12810,39719,40687,"(34.133429999999997, -86.866669999999999)"
Dale County,Alabama,50251,36.1,37774,6759,24825,25426,"(31.45017, -85.649940000000001)"
Dallas County,Alabama,43820,37.700000000000003,32225,6165,20244,23576,"(32.333469999999998, -87.083320000000001)"
DeKalb County,Alabama,71109,37.5,52743,9875,35113,35996,"(34.450090000000003, -85.783299999999997)"
Elmore County,Alabama,79303,37.799999999999997,60596,9436,38689,40614,"(32.583469999999998, -86.149969999999996)"
Escambia County,Alabama,38319,39.200000000000003,29640,5812,19766,18553,"(31.150179999999999, -87.149969999999996)"
Etowah County,Alabama,104430,40.200000000000003,80444,16508,50626,53804,"(34.066760000000002, -86.049970000000002)"
Fayette County,Alabama,17241,42.5,13404,3084,8507,8734,"(33.733440000000002, -87.716679999999997)"
Franklin County,Alabama,31704,37.799999999999997,23837,4825,15828,15876,"(34.450099999999999, -87.850030000000004)"
Geneva County,Alabama,26790,42,20799,4674,13105,13685,"(31.100180000000002, -85.849940000000004)"
Greene County,Alabama,9045,41.8,6851,1454,4271,4774,"(32.85013, -87.983350000000002)"
Hale County,Alabama,15760,40,11845,2370,7466,8294,"(32.758740000000003, -87.633340000000004)"
Henry County,Alabama,17302,42.8,13384,3044,8302,9000,"(31.500450000000001, -85.250209999999996)"
Houston County,Alabama,101547,38.5,76621,14675,48740,52807,"(31.150179999999999, -85.316599999999994)"
Jackson County,Alabama,53227,41.4,41242,8773,26139,27088,"(34.766750000000002, -86.000259999999997)"
Jefferson County,Alabama,658466,37.1,503938,86443,311813,346653,"(33.583440000000003, -86.866659999999996)"
Lamar County,Alabama,14564,43.5,11337,2732,7097,7467,"(33.751779999999997, -88.116699999999994)"
Lauderdale County,Alabama,92709,40.4,72727,15553,44379,48330,"(34.900089999999999, -87.633359999999996)"
Lawrence County,Alabama,34339,40.6,26375,4999,16791,17548,"(34.533430000000003, -87.333349999999996)"
Lee County,Alabama,140247,29.5,108656,12716,69126,71121,"(32.600140000000003, -85.399950000000004)"
Limestone County,Alabama,82782,38.4,62923,10187,41910,40872,"(34.800089999999997, -86.983339999999998)"
Lowndes County,Alabama,11299,40.6,8567,1655,5289,6010,"(32.15014, -86.633309999999994)"
Macon County,Alabama,21452,36.299999999999997,17032,3031,9826,11626,"(32.40014, -85.81662)"
Madison County,Alabama,334811,37.299999999999997,255321,40873,164320,170491,"(34.733420000000002, -86.566659999999999)"
Marengo County,Alabama,21027,40.4,15836,3424,9913,11114,"(32.250419999999998, -87.766679999999994)"
Marion County,Alabama,30776,42.8,24111,5645,15293,15483,"(34.133429999999997, -87.866699999999994)"
Marshall County,Alabama,93019,38.200000000000003,69760,13862,45843,47176,"(34.383420000000001, -86.333320000000001)"
Mobile County,Alabama,412992,36.6,309411,53321,198374,214618,"(30.783519999999999, -88.2)"
Monroe County,Alabama,23068,40.1,17227,3618,11109,11959,"(31.583490000000001, -87.333320000000001)"
Montgomery County,Alabama,229363,34.9,173196,27421,109167,120196,"(32.23348, -86.2333)"
Morgan County,Alabama,119490,39,90866,16871,58886,60604,"(34.450090000000003, -86.85)"
Perry County,Alabama,10591,37.200000000000003,8038,1769,4980,5611,"(32.650129999999997, -87.3)"
Pickens County,Alabama,19746,41.9,15145,3336,9428,10318,"(33.283450000000002, -88.083359999999999)"
Pike County,Alabama,32899,31.4,26217,4211,15700,17199,"(31.81682, -85.949950000000001)"
Randolph County,Alabama,22913,41.2,17440,3888,11104,11809,"(33.30012, -85.466620000000006)"
Russell County,Alabama,52947,35.799999999999997,39448,6720,25287,27660,"(32.350149999999999, -85.199939999999998)"
St. Clair County,Alabama,83593,38.6,63767,10909,41904,41689,"(33.266779999999997, -86.666650000000004)"
Shelby County,Alabama,195085,36.9,145123,20627,95557,99528,"(33.266779999999997, -86.666650000000004)"
Sumter County,Alabama,13763,37.700000000000003,10695,2063,6261,7502,"(32.466799999999999, -88.200029999999998)"
Talladega County,Alabama,82291,39.299999999999997,63006,11591,40077,42214,"(33.366779999999999, -86.183310000000006)"
Tallapoosa County,Alabama,41616,42.4,32397,7193,20190,21426,"(32.816789999999997, -85.833290000000005)"
Tuscaloosa County,Alabama,194656,31.2,152870,21050,94400,100256,"(33.30012, -87.500280000000004)"
Walker County,Alabama,67023,41.2,51916,10894,32668,34355,"(33.800109999999997, -87.3)"
Washington County,Alabama,17581,39.700000000000003,13097,2590,8656,8925,"(31.400169999999999, -88.166669999999996)"
Wilcox County,Alabama,11670,38.799999999999997,8520,1752,5518,6152,"(31.98348, -87.333320000000001)"
Winston County,Alabama,24484,43.1,19185,4333,12021,12463,"(34.150100000000002, -87.366680000000002)"
Aleutians East Borough,Alaska,3141,42.1,2770,155,2093,1048,"(54.85, -163.41667000000001)"
Aleutians West Census Area,Alaska,5561,40.700000000000003,4746,193,3723,1838,"(52.242780000000003, -175.12971999999999)"
Anchorage Municipality,Alaska,291826,32.9,216040,21139,148209,143617,"(61.166670000000003, -149.25056000000001)"
Bethel Census Area,Alaska,17013,26.2,10795,1041,8898,8115,"(60.75056, -160.50056000000001)"
Bristol Bay Borough,Alaska,997,42.8,772,83,540,457,"(58.75056, -156.83332999999999)"
Denali Borough,Alaska,1826,41.5,1415,137,1002,824,"(63.788890000000002, -150.19166999999999)"
Dillingham Census Area,Alaska,4847,29,3252,367,2541,2306,"(58.75056, -156.00056000000001)"
Fairbanks North Star Borough,Alaska,97581,31,72580,6375,51531,46050,"(64.833330000000004, -146.41667000000001)"
Haines Borough,Alaska,2508,46.9,2009,345,1274,1234,"(59.25056, -135.50056000000001)"
Hoonah-Angoon Census Area,Alaska,2150,46,1726,288,1165,985,"(57.948070000000001, -134.94153)"
Juneau City and Borough,Alaska,31275,38.1,23939,2635,15950,15325,"(58.416670000000003, -134.33332999999999)"
Kenai Peninsula Borough,Alaska,55400,40.6,42289,6276,29038,26362,"(60.416670000000003, -151.25056000000001)"
Ketchikan Gateway Borough,Alaska,13477,38.4,10250,1367,6911,6566,"(55.50056, -131.41667000000001)"
Kodiak Island Borough,Alaska,13592,32.5,9698,915,7197,6395,"(57.333329999999997, -153.33332999999999)"
Lake and Peninsula Borough,Alaska,1631,30.8,1139,127,859,772,"(57.00056, -158.00056000000001)"
Matanuska-Susitna Borough,Alaska,88995,34.799999999999997,63276,7069,46040,42955,"(62.50056, -150.00556)"
Nome Census Area,Alaska,9492,27.6,6233,603,5058,4434,"(64.833330000000004, -163.75056000000001)"
North Slope Borough,Alaska,9430,35.1,7179,402,5904,3526,"(69.250559999999993, -152.00056000000001)"
Northwest Arctic Borough,Alaska,7523,25.7,4868,455,4029,3494,"(66.833330000000004, -161.00056000000001)"
Petersburg Census Area,Alaska,3815,41.5,2924,438,1982,1833,"(56.76529, -133.19313)"
Prince of Wales-Hyder Census Area,Alaska,5559,39.9,4135,559,3070,2489,"(56.76529, -133.19313)"
Sitka City and Borough,Alaska,8881,38.200000000000003,6791,1008,4481,4400,"(57.166670000000003, -135.33332999999999)"
Skagway Municipality,Alaska,968,41.2,816,88,500,468,"(59.468519999999998, -135.30596)"
Southeast Fairbanks Census Area,Alaska,7029,37.4,5180,664,3917,3112,"(63.75056, -143.25056000000001)"
Valdez-Cordova Census Area,Alaska,9636,39.799999999999997,7288,798,5143,4493,"(61.50056, -144.50056000000001)"
Wade Hampton Census Area,Alaska,7459,21.9,4358,404,3944,3515,"(62.25056, -163.00056000000001)"
Wrangell City and Borough,Alaska,2369,46.7,1849,374,1242,1127,"(62.25056, -163.00056000000001)"
Yakutat City and Borough,Alaska,662,39.700000000000003,500,64,360,302,"(59.666670000000003, -139.13333)"
Yukon-Koyukuk Census Area,Alaska,5588,35.299999999999997,4036,569,3027,2561,"(65.7, -152.71666999999999)"
Apache County,Arizona,71518,32.4,48858,8268,35678,35840,"(35.008360000000003, -109.37566)"
Cochise County,Arizona,131346,39.700000000000003,101096,22688,66977,64369,"(31.932030000000001, -109.74229)"
Coconino County,Arizona,134421,31,102633,11924,66666,67755,"(36.083320000000001, -112.13406000000001)"
Gila County,Arizona,53597,47.9,42126,12450,26633,26964,"(33.516719999999999, -110.51733)"
Graham County,Arizona,37220,31.6,26645,4261,19977,17243,"(33.016730000000003, -110.01730999999999)"
Greenlee County,Arizona,8437,34.799999999999997,5974,1016,4398,4039,"(33.375059999999998, -109.37563)"
La Paz County,Arizona,20489,53.9,16811,6683,10550,9939,"(33.625590000000003, -113.87633)"
Maricopa County,Arizona,3817117,34.6,2809256,462641,1888465,1928652,"(33.500039999999998, -112.50072)"
Mohave County,Arizona,200186,47.6,158921,46658,100078,100108,"(36.083320000000001, -113.76745)"
Navajo County,Arizona,107449,34.700000000000003,75476,14241,53777,53672,"(36.9375, -110.81319000000001)"
Pima County,Arizona,980263,37.700000000000003,754947,151293,481437,498826,"(32.000349999999997, -112.00346)"
Pinal County,Arizona,375770,35.299999999999997,276070,52071,197165,178605,"(33.000619999999998, -111.51734999999999)"
Santa Cruz County,Arizona,47420,35.6,32860,6224,22559,24861,"(31.58343, -110.58396999999999)"
Yavapai County,Arizona,211033,49.2,170764,50767,103458,107575,"(34.508360000000003, -112.37572)"
Yuma County,Arizona,195751,33.799999999999997,140566,30646,98005,97746,"(32.751440000000002, -113.76743)"
Arkansas County,Arkansas,19019,40.700000000000003,14594,3115,9220,9799,"(34.316769999999998, -91.400120000000001)"
Ashley County,Arkansas,21853,40.299999999999997,16523,3544,10598,11255,"(33.183450000000001, -91.783460000000005)"
Baxter County,Arkansas,41513,50.6,34007,11659,20023,21490,"(36.333399999999997, -92.366829999999993)"
Benton County,Arkansas,221339,34.299999999999997,159491,26986,109124,112215,"(36.333410000000001, -94.333539999999999)"
Boone County,Arkansas,36903,41.4,28318,6673,18066,18837,"(36.300069999999998, -93.154619999999994)"
Bradley County,Arkansas,11508,40.299999999999997,8827,2041,5587,5921,"(33.433450000000001, -92.166809999999998)"
Calhoun County,Arkansas,5368,43.4,4266,923,2719,2649,"(33.566780000000001, -92.500429999999994)"
Carroll County,Arkansas,27446,44,21263,5131,13531,13915,"(36.333399999999997, -93.516850000000005)"
Chicot County,Arkansas,11800,41.8,9076,2149,5793,6007,"(33.283450000000002, -91.300110000000004)"
Clark County,Arkansas,22995,33.5,18515,3410,10972,12023,"(34.0501, -93.166839999999993)"
Clay County,Arkansas,16083,43.2,12493,3220,7871,8212,"(36.366729999999997, -90.383439999999993)"
Cleburne County,Arkansas,25970,46.8,20808,6118,12777,13193,"(35.516750000000002, -92.016819999999996)"
Cleveland County,Arkansas,8689,40.200000000000003,6538,1416,4287,4402,"(33.900100000000002, -92.200149999999994)"
Columbia County,Arkansas,24552,37,18958,3928,11715,12837,"(33.216799999999999, -93.233500000000006)"
Conway County,Arkansas,21273,40.5,16128,3592,10533,10740,"(35.250360000000001, -92.683499999999995)"
Craighead County,Arkansas,96443,33.200000000000003,72302,11740,47077,49366,"(35.816740000000003, -90.650109999999998)"
Crawford County,Arkansas,61948,37.6,45598,8233,30571,31377,"(35.583419999999997, -94.233540000000005)"
Crittenden County,Arkansas,50902,34.200000000000003,36093,5477,24166,26736,"(35.233420000000002, -90.283429999999996)"
Cross County,Arkansas,17870,39.700000000000003,13376,2759,8621,9249,"(35.300089999999997, -90.766779999999997)"
Dallas County,Arkansas,8116,42.7,6203,1474,3974,4142,"(33.966769999999997, -92.666830000000004)"
Desha County,Arkansas,13008,38.700000000000003,9631,1970,6103,6905,"(33.783439999999999, -91.316779999999994)"
Drew County,Arkansas,18509,36.9,14148,2735,8985,9524,"(33.600110000000001, -91.716800000000006)"
Faulkner County,Arkansas,113237,31.5,85495,11318,55623,57614,"(35.16675, -92.333489999999998)"
Franklin County,Arkansas,18125,39.799999999999997,13694,3007,8977,9148,"(35.550080000000001, -93.866860000000003)"
Fulton County,Arkansas,12245,47,9647,2742,5999,6246,"(36.366729999999997, -91.833479999999994)"
Garland County,Arkansas,96024,44.4,75931,20098,46614,49410,"(34.566760000000002, -93.150180000000006)"
Grant County,Arkansas,17853,39.5,13538,2591,8869,8984,"(34.283430000000003, -92.400149999999996)"
Greene County,Arkansas,42090,37.9,31500,6034,20642,21448,"(36.116729999999997, -90.550110000000004)"
Hempstead County,Arkansas,22609,37.700000000000003,16731,3396,10905,11704,"(33.71678, -93.666849999999997)"
Hot Spring County,Arkansas,32923,40.1,25237,5164,16813,16110,"(34.350090000000002, -92.900170000000003)"
Howard County,Arkansas,13789,38.4,10166,2104,6656,7133,"(34.100110000000001, -94.016859999999994)"
Independence County,Arkansas,36647,39,27855,5730,17960,18687,"(35.750349999999997, -91.566800000000001)"
Izard County,Arkansas,13696,47.3,11071,3229,7054,6642,"(36.100070000000002, -91.900149999999996)"
Jackson County,Arkansas,17997,40.5,14263,2856,8930,9067,"(35.600079999999998, -91.200130000000001)"
Jefferson County,Arkansas,77435,37.4,59007,10255,38067,39368,"(34.233429999999998, -91.900139999999993)"
Johnson County,Arkansas,25540,37.200000000000003,19211,3749,12659,12881,"(35.566749999999999, -93.450180000000003)"
Lafayette County,Arkansas,7645,43.3,5869,1483,3693,3952,"(33.26679, -93.600179999999995)"
Lawrence County,Arkansas,17415,40.9,13423,3160,8468,8947,"(36.0334, -91.116789999999995)"
Lee County,Arkansas,10424,39.799999999999997,8264,1607,5806,4618,"(34.766759999999998, -90.766779999999997)"
Lincoln County,Arkansas,14134,38,11391,1758,8501,5633,"(33.966769999999997, -91.733459999999994)"
Little River County,Arkansas,13171,41.2,10034,2253,6403,6768,"(33.700119999999998, -94.233530000000002)"
Logan County,Arkansas,22353,41.4,16862,3842,11198,11155,"(35.216760000000001, -93.700190000000006)"
Lonoke County,Arkansas,68356,35.299999999999997,49525,7625,33629,34727,"(34.766759999999998, -91.883470000000003)"
Madison County,Arkansas,15717,40.9,11916,2452,7881,7836,"(36.000349999999997, -93.700190000000006)"
Marion County,Arkansas,16653,50.1,13670,3964,8287,8366,"(36.233400000000003, -92.683499999999995)"
Miller County,Arkansas,43462,37.200000000000003,32913,5982,21401,22061,"(33.283459999999998, -93.883510000000001)"
Mississippi County,Arkansas,46480,34.9,33376,5685,22498,23982,"(35.766739999999999, -90.050089999999997)"
Monroe County,Arkansas,8149,44.2,6309,1541,3895,4254,"(34.666759999999996, -91.216790000000003)"
Montgomery County,Arkansas,9487,46.8,7489,2126,4730,4757,"(34.533430000000003, -93.650189999999995)"
Nevada County,Arkansas,8997,41.6,6866,1588,4409,4588,"(33.650120000000001, -93.333500000000001)"
Newton County,Arkansas,8330,46,6594,1701,4206,4124,"(35.933410000000002, -93.200180000000003)"
Ouachita County,Arkansas,26120,42.1,19975,4451,12379,13741,"(33.583449999999999, -92.90016)"
Perry County,Arkansas,10445,41.6,8043,1747,5183,5262,"(34.933419999999998, -92.966840000000005)"
Phillips County,Arkansas,21757,36.9,15644,3254,10130,11627,"(34.450099999999999, -90.833449999999999)"
Pike County,Arkansas,11291,40.200000000000003,8504,1962,5599,5692,"(34.150109999999998, -93.666849999999997)"
Poinsett County,Arkansas,24583,39.799999999999997,18624,3900,11937,12646,"(35.566749999999999, -90.650109999999998)"
Polk County,Arkansas,20662,43.1,15741,4025,10163,10499,"(34.500390000000003, -94.26688)"
Pope County,Arkansas,61754,35.1,47513,8113,30610,31144,"(35.45008, -93.050169999999994)"
Prairie County,Arkansas,8715,44.5,6837,1717,4314,4401,"(34.800089999999997, -91.550129999999996)"
Pulaski County,Arkansas,382748,36,290563,45908,183938,198810,"(34.766759999999998, -92.300150000000002)"
Randolph County,Arkansas,17969,41.9,13798,3361,8810,9159,"(36.350070000000002, -91.01679)"
St. Francis County,Arkansas,28258,37.200000000000003,21581,3447,15393,12865,"(36.150069999999999, -91.516810000000007)"
Saline County,Arkansas,107118,38.799999999999997,80979,15875,52899,54219,"(34.650089999999999, -92.683499999999995)"
Scott County,Arkansas,11233,39.799999999999997,8350,1915,5663,5570,"(34.866770000000002, -94.033540000000002)"
Searcy County,Arkansas,8195,46.8,6520,1745,4085,4110,"(35.900080000000003, -92.733500000000006)"
Sebastian County,Arkansas,125744,36.700000000000003,93862,16518,61633,64111,"(35.166759999999996, -94.26688)"
Sevier County,Arkansas,17058,33.700000000000003,12018,2147,8464,8594,"(33.983449999999998, -94.250479999999996)"
Sharp County,Arkansas,17264,47,13547,4134,8532,8732,"(36.150069999999999, -91.516810000000007)"
Stone County,Arkansas,12394,47.7,9839,2826,6128,6266,"(35.850070000000002, -92.183490000000006)"
Union County,Arkansas,41639,40.1,31578,6481,20259,21380,"(33.150129999999997, -92.65016)"
Van Buren County,Arkansas,17295,46.6,13758,3923,8622,8673,"(35.566740000000003, -92.483490000000003)"
Washington County,Arkansas,203065,30.7,151581,19641,101486,101579,"(35.966749999999998, -94.233540000000005)"
White County,Arkansas,77076,36,58643,10848,37802,39274,"(35.250360000000001, -91.733469999999997)"
Woodruff County,Arkansas,7260,43.3,5588,1293,3452,3808,"(35.183419999999998, -91.233459999999994)"
Yell County,Arkansas,22185,37.799999999999997,16354,3417,11070,11115,"(35.000369999999997, -93.416849999999997)"
Alameda County,California,1510271,36.6,1169650,167746,740573,769698,"(37.599930000000001, -121.8844)"
Alpine County,California,1175,46.7,919,166,606,569,"(38.599910000000001, -119.80101000000001)"
Amador County,California,38091,48.2,31698,7865,20749,17342,"(38.449910000000003, -120.65103999999999)"
Butte County,California,220000,37.200000000000003,173832,33817,108931,111069,"(39.649880000000003, -121.56775)"
Calaveras County,California,45578,49.2,36635,9565,22822,22756,"(38.166589999999999, -120.58437000000001)"
Colusa County,California,21419,33.5,15009,2495,11012,10407,"(39.183219999999999, -122.26775000000001)"
Contra Costa County,California,1049025,38.5,788520,130438,511526,537499,"(37.933259999999997, -121.9344)"
Del Norte County,California,28610,39.1,22472,3873,15907,12703,"(41.699840000000002, -123.90118)"
El Dorado County,California,181058,43.6,139883,26524,90571,90487,"(38.766570000000002, -120.5177)"
Fresno County,California,930450,30.6,652943,93421,464811,465639,"(36.666620000000002, -119.83431)"
Glenn County,California,28122,35.299999999999997,20257,3737,14191,13931,"(39.599879999999999, -122.43443000000001)"
Humboldt County,California,134623,37.1,107562,17725,67595,67028,"(40.666519999999998, -123.91783)"
Imperial County,California,174528,31.9,123430,18152,89646,84882,"(33.033380000000001, -115.41748)"
Inyo County,California,18546,45.6,14646,3535,9354,9192,"(36.583269999999999, -117.41757)"
Kern County,California,839631,30.7,585550,75437,433108,406523,"(35.29607, -118.66759)"
Kings County,California,152982,31.1,110434,12030,86344,66638,"(36.033290000000001, -119.8343)"
Lake County,California,64665,45,50993,11440,32469,32196,"(39.099890000000002, -122.78444)"
Lassen County,California,34895,37.1,28602,3474,22416,12479,"(40.666559999999997, -120.5844)"
Los Angeles County,California,9818605,34.799999999999997,7416397,1065699,4839654,4978951,"(34.366660000000003, -118.20090999999999)"
Madera County,California,150865,33,108016,17262,72682,78183,"(37.166609999999999, -119.83432000000001)"
Marin County,California,252409,44.5,200195,42192,124072,128337,"(38.066589999999998, -122.73443)"
Mariposa County,California,18251,49.2,15009,3821,9269,8982,"(37.549939999999999, -119.90101)"
Mendocino County,California,87841,41.5,68380,13493,43983,43858,"(39.416550000000001, -123.41779)"
Merced County,California,255793,29.6,175095,23960,128737,127056,"(37.166609999999999, -120.75158)"
Modoc County,California,9686,46.1,7562,1905,4878,4808,"(41.566560000000003, -120.73441)"
Mono County,California,14202,37.200000000000003,11223,1377,7548,6654,"(37.916600000000003, -118.86763999999999)"
Monterey County,California,415057,32.9,304044,44422,213431,201626,"(36.250520000000002, -121.25158999999999)"
Napa County,California,136484,39.700000000000003,104998,20594,68159,68325,"(38.483240000000002, -122.33441999999999)"
Nevada County,California,98764,47.6,79658,19174,48835,49929,"(39.349899999999998, -120.88439)"
Orange County,California,3010232,36.200000000000003,2273573,349677,1488780,1521452,"(33.700020000000002, -117.76755)"
Placer County,California,348432,40.299999999999997,263347,53562,170151,178281,"(39.066569999999999, -120.76770999999999)"
Plumas County,California,20007,49.6,16406,4154,10003,10004,"(39.983229999999999, -120.86772999999999)"
Riverside County,California,2189641,33.700000000000003,1569533,258586,1089576,1100065,"(33.733350000000002, -116.05083)"
Sacramento County,California,1418788,34.799999999999997,1055735,158551,694793,723995,"(38.46658, -121.31773)"
San Benito County,California,55269,34.299999999999997,39203,5360,27629,27640,"(36.616630000000001, -121.08436)"
San Bernardino County,California,2035210,31.7,1440622,181348,1011507,1023703,"(34.66666, -116.16750999999999)"
San Diego County,California,3095313,34.6,2371145,351425,1553679,1541634,"(33.033380000000001, -116.80086)"
San Francisco County,California,805235,38.5,697711,109842,408462,396773,"(37.766599999999997, -122.45108)"
San Joaquin County,California,685306,32.700000000000003,484582,71181,341230,344076,"(37.933259999999997, -121.30106000000001)"
San Luis Obispo County,California,269637,39.4,218796,41022,137999,131638,"(35.366639999999997, -120.53433)"
San Mateo County,California,718451,39.299999999999997,558679,96262,353168,365283,"(37.449939999999998, -122.35108)"
Santa Barbara County,California,423895,33.6,325848,54398,212786,211109,"(34.733319999999999, -120.03431)"
Santa Clara County,California,1781642,36.200000000000003,1352097,196944,893851,887791,"(37.233280000000001, -121.76773)"
Santa Cruz County,California,262382,36.9,206964,29158,130913,131469,"(37.066609999999997, -122.05107)"
Shasta County,California,177223,41.8,137571,29967,87130,90093,"(40.766539999999999, -122.03444)"
Sierra County,California,3240,50.9,2688,676,1646,1594,"(39.58323, -120.55105)"
Siskiyou County,California,44900,47,35575,8782,22395,22505,"(41.583199999999998, -122.51779999999999)"
Solano County,California,413344,36.9,311809,46847,206195,207149,"(38.233249999999998, -121.95107)"
Sonoma County,California,483878,39.9,377407,67364,237902,245976,"(38.549999999999997, -122.90111)"
Stanislaus County,California,514453,32.9,367295,54831,254489,259964,"(37.549930000000003, -121.0016)"
Sutter County,California,94737,34.5,68625,11990,47001,47736,"(39.016559999999998, -121.70108)"
Tehama County,California,63463,39.5,47303,10071,31610,31853,"(40.133209999999998, -122.30110999999999)"
Trinity County,California,13786,49.3,11266,2769,7113,6673,"(40.583199999999998, -123.16781)"
Tulare County,California,442179,29.6,298055,41779,221442,220737,"(36.26661, -118.80092999999999)"
Tuolumne County,California,55365,47.3,45683,11294,29245,26120,"(38.066589999999998, -119.90101)"
Ventura County,California,823318,36.200000000000003,611403,96309,408969,414349,"(34.466659999999997, -119.0176)"
Yolo County,California,200849,30.4,155218,19771,97935,102914,"(38.6999, -121.88441)"
Yuba County,California,72155,32.1,51165,7255,36352,35803,"(39.28322, -121.40107)"
Adams County,Colorado,441603,32.4,315480,36862,222142,219461,"(39.86665, -104.38385)"
Alamosa County,Colorado,15445,32.9,11617,1752,7745,7700,"(37.6, -105.80058)"
Arapahoe County,Colorado,572003,35.700000000000003,424679,57580,280345,291658,"(39.649979999999999, -104.38385)"
Archuleta County,Colorado,12084,48.4,9676,2116,6103,5981,"(37.183340000000001, -107.03393)"
Baca County,Colorado,3788,47.4,2974,911,1877,1911,"(37.333350000000003, -102.55047)"
Bent County,Colorado,6499,39.799999999999997,5403,888,4270,2229,"(37.966670000000001, -103.06715)"
Boulder County,Colorado,294567,35.799999999999997,231813,29521,147916,146651,"(40.083320000000001, -105.35055)"
Broomfield County,Colorado,55889,36.4,41237,5508,27729,28160,"(39.920540000000003, -105.08665000000001)"
Chaffee County,Colorado,17809,47.4,14821,3523,9453,8356,"(38.766660000000002, -106.18391)"
Cheyenne County,Colorado,1836,42.7,1386,328,910,926,"(38.83334, -102.60047)"
Clear Creek County,Colorado,9088,46.6,7517,1132,4735,4353,"(39.683320000000002, -105.65056)"
Conejos County,Colorado,8256,38.200000000000003,5920,1254,4093,4163,"(37.216670000000001, -106.18392)"
Costilla County,Colorado,3524,49,2788,807,1822,1702,"(37.266680000000001, -105.43389999999999)"
Crowley County,Colorado,5823,38.9,5034,614,4199,1624,"(38.35, -103.78384)"
Custer County,Colorado,4255,53.3,3525,954,2195,2060,"(38.116669999999999, -105.36722)"
Delta County,Colorado,30952,45.6,24101,6239,15590,15362,"(38.849980000000002, -107.85062000000001)"
Denver County,Colorado,600158,33.700000000000003,471392,62132,300089,300069,"(39.666649999999997, -104.95054)"
Dolores County,Colorado,2064,44.7,1602,388,1063,1001,"(37.766660000000002, -108.51730999999999)"
Douglas County,Colorado,285465,36.6,198453,20343,141253,144212,"(39.333320000000001, -104.95054)"
Eagle County,Colorado,52197,34,39397,2938,27820,24377,"(39.633319999999998, -106.70059000000001)"
Elbert County,Colorado,23086,43.8,17232,2193,11553,11533,"(39.299990000000001, -104.05051)"
El Paso County,Colorado,622263,34.1,459587,62051,310162,312101,"(38.833329999999997, -104.51719)"
Fremont County,Colorado,46824,43.6,38613,8244,27032,19792,"(38.483330000000002, -105.40055)"
Garfield County,Colorado,56389,34.5,41173,4717,29107,27282,"(39.549979999999998, -107.83396)"
Gilpin County,Colorado,5441,45.6,4482,514,2883,2558,"(39.849989999999998, -105.51721999999999)"
Grand County,Colorado,14843,41.2,11825,1519,7929,6914,"(40.066650000000003, -106.08391)"
Gunnison County,Colorado,15324,34.299999999999997,12544,1351,8306,7018,"(38.69999, -107.06726999999999)"
Hinsdale County,Colorado,843,47.1,675,147,443,400,"(37.85, -107.33394)"
Huerfano County,Colorado,6711,51.8,5523,1689,3332,3379,"(37.683340000000001, -104.95055000000001)"
Jackson County,Colorado,1394,47.3,1134,257,736,658,"(40.666640000000001, -106.33392000000001)"
Jefferson County,Colorado,534543,40.4,415453,67411,265317,269226,"(39.633319999999998, -105.26721000000001)"
Kiowa County,Colorado,1398,47.4,1084,300,687,711,"(38.433340000000001, -102.81713999999999)"
Kit Carson County,Colorado,8270,39.700000000000003,6431,1322,4638,3632,"(39.299990000000001, -102.56713999999999)"
Lake County,Colorado,7310,35,5488,647,3913,3397,"(39.216659999999997, -106.33391)"
La Plata County,Colorado,51334,38.4,40822,5979,26138,25196,"(37.283340000000003, -107.81729)"
Larimer County,Colorado,299630,35.5,235573,35541,148637,150993,"(40.666649999999997, -105.46720999999999)"
Las Animas County,Colorado,15507,43.9,12266,2748,7948,7559,"(37.416679999999999, -104.00108)"
Lincoln County,Colorado,5467,40.9,4347,918,3163,2304,"(39.049990000000001, -103.45050000000001)"
Logan County,Colorado,22709,38.4,18167,3321,12924,9785,"(40.716659999999997, -103.11715)"
Mesa County,Colorado,146723,38.1,112206,21872,72866,73857,"(39.033320000000003, -108.46731)"
Mineral County,Colorado,712,53.1,611,164,362,350,"(37.666670000000003, -106.91727)"
Moffat County,Colorado,13795,35.799999999999997,10062,1454,7047,6748,"(40.649970000000003, -108.08396999999999)"
Montezuma County,Colorado,25535,42.9,19536,4269,12605,12930,"(37.333329999999997, -108.55065)"
Montrose County,Colorado,41276,42,31097,7349,20310,20966,"(38.416649999999997, -108.26730000000001)"
Morgan County,Colorado,28159,36,20284,3965,13898,14261,"(40.266649999999998, -103.81717)"
Otero County,Colorado,18831,40.9,14171,3458,9221,9610,"(37.900010000000002, -103.71717)"
Ouray County,Colorado,4436,50,3639,777,2224,2212,"(38.149990000000003, -107.76728)"
Park County,Colorado,16206,46.9,13098,1881,8504,7702,"(39.149990000000003, -105.76723)"
Phillips County,Colorado,4442,42.8,3320,919,2172,2270,"(40.599989999999998, -102.36713)"
Pitkin County,Colorado,17148,42,14149,1964,9095,8053,"(39.19999, -106.93393)"
Prowers County,Colorado,12551,36.700000000000003,9147,1835,6203,6348,"(37.966679999999997, -102.40047)"
Pueblo County,Colorado,159063,38.700000000000003,120148,24346,78201,80862,"(38.183340000000001, -104.48386000000001)"
Rio Blanco County,Colorado,6666,38,5045,827,3432,3234,"(39.94997, -108.20064000000001)"
Rio Grande County,Colorado,11982,41,8957,1945,5957,6025,"(37.566670000000002, -106.40058999999999)"
Routt County,Colorado,23509,38.9,18600,1909,12497,11012,"(40.516640000000002, -106.98394)"
Saguache County,Colorado,6108,43.3,4692,893,3121,2987,"(38.083329999999997, -106.25114000000001)"
San Juan County,Colorado,699,43.8,571,86,392,307,"(37.750549999999997, -107.66728000000001)"
San Miguel County,Colorado,7359,39.299999999999997,5912,517,3996,3363,"(38.016660000000002, -108.45064000000001)"
Sedgwick County,Colorado,2379,49.2,1919,569,1174,1205,"(40.866660000000003, -102.35046)"
Summit County,Colorado,27994,36.4,23110,2158,15378,12616,"(39.599989999999998, -106.01724)"
Teller County,Colorado,23350,47,18570,3023,11885,11465,"(38.866660000000003, -105.16721)"
Washington County,Colorado,4814,44.2,3689,928,2458,2356,"(39.966650000000001, -103.20050000000001)"
Weld County,Colorado,252825,33.1,182424,24235,126487,126338,"(40.633310000000002, -104.53385)"
Yuma County,Colorado,10043,38.5,7396,1623,4980,5063,"(39.983319999999999, -102.43380999999999)"
Fairfield County,Connecticut,916829,39.5,689810,124075,445601,471228,"(41.266759999999998, -73.316230000000004)"
Hartford County,Connecticut,894014,39.9,689971,130119,432013,462001,"(41.766770000000001, -72.766210000000001)"
Litchfield County,Connecticut,189927,44.4,148975,30342,93338,96589,"(41.766759999999998, -73.250119999999995)"
Middlesex County,Connecticut,165676,43.1,130578,25621,80908,84768,"(41.466769999999997, -72.532870000000003)"
New Haven County,Connecticut,862477,39.299999999999997,669503,123972,415090,447387,"(41.400100000000002, -72.932879999999997)"
New London County,Connecticut,274055,40.4,214456,38995,136803,137252,"(41.483429999999998, -72.066190000000006)"
Tolland County,Connecticut,152691,38.299999999999997,121807,18220,77163,75528,"(41.850099999999998, -72.349530000000001)"
Windham County,Connecticut,118428,39.200000000000003,91982,15215,58698,59730,"(41.83343, -72.000069999999994)"
Kent County,Delaware,162310,36.6,121931,21982,78035,84275,"(39.083449999999999, -75.54965)"
New Castle County,Delaware,538479,37.200000000000003,413400,66222,260671,277808,"(39.791780000000003, -75.632980000000003)"
Sussex County,Delaware,197145,45.4,156838,41073,96233,100912,"(38.700110000000002, -75.416309999999996)"
District of Columbia,District of Columbia,601723,33.799999999999997,500908,68809,284222,317501,"(38.700110000000002, -75.416309999999996)"
Alachua County,Florida,247336,30.1,203051,26627,119786,127550,"(29.708580000000001, -82.333160000000007)"
Baker County,Florida,27115,36,20068,2956,14160,12955,"(30.333570000000002, -82.291510000000002)"
Bay County,Florida,168852,39.5,131776,24559,83656,85196,"(30.20853, -85.624369999999999)"
Bradford County,Florida,28520,39.5,22885,4113,16010,12510,"(29.950240000000001, -82.149829999999994)"
Brevard County,Florida,543376,45.5,435690,110712,266242,277134,"(28.29195, -80.749219999999994)"
Broward County,Florida,1748066,39.700000000000003,1356717,249424,846571,901495,"(26.150359999999999, -80.483109999999996)"
Calhoun County,Florida,14625,39.700000000000003,11493,2258,7955,6670,"(30.41686, -85.166589999999999)"
Charlotte County,Florida,159978,55.9,137100,54599,77762,82216,"(26.917010000000001, -81.916470000000004)"
Citrus County,Florida,141236,54,118842,45041,68359,72877,"(28.874700000000001, -82.458150000000003)"
Clay County,Florida,190865,38,140695,22292,93491,97374,"(29.999680000000001, -81.833150000000003)"
Collier County,Florida,321520,46.9,258873,84951,158494,163026,"(26.133700000000001, -81.483140000000006)"
Columbia County,Florida,67531,39.9,52338,10390,34951,32580,"(30.250789999999999, -82.624290000000002)"
DeSoto County,Florida,34862,38.1,27027,6228,19718,15144,"(27.18366, -81.799800000000005)"
Dixie County,Florida,16422,45.4,13278,3170,8842,7580,"(29.624680000000001, -83.166520000000006)"
Duval County,Florida,864263,35.799999999999997,660749,96169,419425,444838,"(30.356909999999999, -81.631479999999996)"
Escambia County,Florida,297619,37.6,233465,42929,147119,150500,"(30.66686, -87.333309999999997)"
Flagler County,Florida,95696,47.5,76660,23405,46016,49680,"(29.458590000000001, -81.291449999999998)"
Franklin County,Florida,11549,42.4,9579,2015,6656,4893,"(29.874649999999999, -84.791569999999993)"
Gadsden County,Florida,46389,38.9,35184,6323,22647,23742,"(30.56325, -84.602689999999996)"
Gilchrist County,Florida,16939,40.6,13308,2856,8836,8103,"(29.708570000000002, -82.791510000000002)"
Glades County,Florida,12884,43.1,10467,2767,7443,5441,"(26.958670000000001, -81.166460000000001)"
Gulf County,Florida,15863,42.7,13289,2587,9484,6379,"(29.958539999999999, -85.208250000000007)"
Hamilton County,Florida,14799,38.1,11886,1946,8721,6078,"(30.507439999999999, -82.933750000000003)"
Hardee County,Florida,27731,32.799999999999997,20056,3575,14868,12863,"(27.458649999999999, -81.803970000000007)"
Hendry County,Florida,39140,32.799999999999997,28254,4491,21198,17942,"(26.500630000000001, -81.199789999999993)"
Hernando County,Florida,172778,47.7,138620,44523,82534,90244,"(28.54194, -82.458150000000003)"
Highlands County,Florida,98786,51.5,80814,31822,48273,50513,"(27.366990000000001, -81.349789999999999)"
Hillsborough County,Florida,1229226,36.1,935018,145237,599084,630142,"(27.916969999999999, -82.349810000000005)"
Holmes County,Florida,19927,41.3,15645,3425,10594,9333,"(30.882680000000001, -85.808819999999997)"
Indian River County,Florida,138028,49.1,112076,37504,66748,71280,"(27.687809999999999, -80.583110000000005)"
Jackson County,Florida,49746,40.5,39839,7801,27252,22494,"(30.79186, -85.166600000000003)"
Jefferson County,Florida,14761,44.1,12013,2432,7727,7034,"(30.416869999999999, -83.895719999999997)"
Lafayette County,Florida,8870,36.200000000000003,7085,1084,5481,3389,"(29.958559999999999, -83.208190000000002)"
Lake County,Florida,297052,45.6,235311,71825,143937,153115,"(28.79194, -81.791470000000004)"
Lee County,Florida,618754,45.6,497885,145106,303600,315154,"(26.567019999999999, -81.883139999999997)"
Leon County,Florida,275487,29.6,221514,25980,131134,144353,"(30.49464, -84.20823)"
Levy County,Florida,40801,45,32172,7914,20078,20723,"(29.291910000000001, -82.749279999999999)"
Liberty County,Florida,8365,37,6588,888,5092,3273,"(30.25075, -84.875470000000007)"
Madison County,Florida,19224,40.200000000000003,15037,3045,10035,9189,"(30.458819999999999, -83.457930000000005)"
Manatee County,Florida,322833,45.7,256550,75109,156115,166718,"(27.500869999999999, -82.291480000000007)"
Marion County,Florida,331298,47.3,267117,85318,158993,172305,"(29.249700000000001, -82.041480000000007)"
Martin County,Florida,146318,49.7,120572,39972,72423,73895,"(27.083659999999998, -80.416439999999994)"
Miami-Dade County,Florida,2496435,38.200000000000003,1950707,352013,1208364,1288071,"(25.617049999999999, -80.533109999999994)"
Monroe County,Florida,73090,46.4,62089,12469,38962,34128,"(25.312899999999999, -80.937290000000004)"
Nassau County,Florida,73314,42.9,57395,11908,36146,37168,"(30.646070000000002, -81.791499999999999)"
Okaloosa County,Florida,180822,38.299999999999997,140434,25218,90843,89979,"(30.68741, -86.562449999999998)"
Okeechobee County,Florida,39996,38.6,30412,6791,21430,18566,"(27.416989999999998, -80.916449999999998)"
Orange County,Florida,1145956,33.700000000000003,875809,110919,564326,581630,"(28.45862, -81.291460000000001)"
Osceola County,Florida,268685,35.6,198269,29656,131634,137051,"(28.04196, -81.124229999999997)"
Palm Beach County,Florida,1320134,43.5,1051250,285155,638888,681246,"(26.65034, -80.449770000000001)"
Pasco County,Florida,464697,43.6,366124,96245,225886,238811,"(28.29195, -82.416480000000007)"
Pinellas County,Florida,916542,46.3,753654,194099,440009,476533,"(27.896129999999999, -82.708160000000007)"
Polk County,Florida,602095,39.799999999999997,460359,108296,295313,306782,"(27.958629999999999, -81.708129999999997)"
Putnam County,Florida,74364,43.4,57579,14070,36884,37480,"(29.666910000000001, -81.749250000000004)"
St. Johns County,Florida,190039,42.2,146188,29793,92425,97614,"(28.70861, -81.208119999999994)"
St. Lucie County,Florida,277789,42.4,215781,55378,135859,141930,"(28.70861, -81.208119999999994)"
Santa Rosa County,Florida,151372,39.200000000000003,115163,19460,76422,74950,"(30.70852, -87.041629999999998)"
Sarasota County,Florida,379448,52.5,319713,118227,181041,198407,"(27.167000000000002, -82.333150000000003)"
Seminole County,Florida,422718,38.200000000000003,325537,50677,204799,217919,"(28.70861, -81.208119999999994)"
Sumter County,Florida,93420,62.7,84908,40530,48611,44809,"(28.708600000000001, -82.08314)"
Suwannee County,Florida,41551,42.2,32102,7850,20945,20606,"(30.249669999999998, -82.999300000000005)"
Taylor County,Florida,22570,41.1,18125,3528,12554,10016,"(30.083549999999999, -83.583200000000005)"
Union County,Florida,15535,39.1,12525,1554,10045,5490,"(30.041910000000001, -82.374279999999999)"
Volusia County,Florida,494593,45.3,401320,104289,241715,252878,"(29.083590000000001, -81.208119999999994)"
Wakulla County,Florida,30776,38.799999999999997,23851,3339,16992,13784,"(30.166869999999999, -84.33323)"
Walton County,Florida,55043,42.1,43713,8943,28177,26866,"(30.62575, -86.166610000000006)"
Washington County,Florida,24896,40.299999999999997,19626,3827,13575,11321,"(30.600190000000001, -85.666600000000003)"
Appling County,Georgia,18236,38.1,13542,2456,9159,9077,"(31.766860000000001, -82.299850000000006)"
Atkinson County,Georgia,8375,33.4,5945,890,4240,4135,"(31.3002, -82.866529999999997)"
Bacon County,Georgia,11096,36.9,8270,1480,5491,5605,"(31.5502, -82.466520000000003)"
Baker County,Georgia,3451,41.6,2650,530,1673,1778,"(31.300180000000001, -84.449910000000003)"
Baldwin County,Georgia,45720,34.1,36369,5508,22683,23037,"(33.066809999999997, -83.149870000000007)"
Banks County,Georgia,18395,38.4,13752,2300,9298,9097,"(34.350099999999998, -83.500439999999998)"
Barrow County,Georgia,69367,33.6,49778,6472,34208,35159,"(33.983440000000002, -83.716560000000001)"
Bartow County,Georgia,100157,36.200000000000003,73357,10611,49433,50724,"(34.250369999999997, -84.849940000000004)"
Ben Hill County,Georgia,17634,37.1,12966,2468,8439,9195,"(31.75018, -83.23321)"
Berrien County,Georgia,19286,38,14347,2664,9501,9785,"(31.266860000000001, -83.249880000000005)"
Bibb County,Georgia,155547,35.6,115428,19689,73286,82261,"(32.800139999999999, -83.666569999999993)"
Bleckley County,Georgia,13063,35.9,10114,1971,6217,6846,"(32.433489999999999, -83.316550000000007)"
Brantley County,Georgia,18411,37.799999999999997,13518,2260,9189,9222,"(31.200220000000002, -81.983170000000001)"
Brooks County,Georgia,16243,40.299999999999997,12393,2560,7901,8342,"(30.850190000000001, -83.566550000000007)"
Bryan County,Georgia,30233,35.700000000000003,21376,2715,14852,15381,"(32.016869999999997, -81.449830000000006)"
Bulloch County,Georgia,70217,25.9,55824,6401,35030,35187,"(32.416849999999997, -81.750389999999996)"
Burke County,Georgia,23316,35.9,16731,2767,11186,12130,"(33.06682, -82.000399999999999)"
Butts County,Georgia,23655,38.1,18330,2985,12522,11133,"(33.30012, -83.966579999999993)"
Calhoun County,Georgia,6694,38.700000000000003,5374,797,3953,2741,"(31.53351, -84.616579999999999)"
Camden County,Georgia,50513,31.3,36861,4556,25569,24944,"(30.950230000000001, -81.666489999999996)"
Candler County,Georgia,10998,37.6,8179,1584,5437,5561,"(32.500720000000001, -82.066509999999994)"
Carroll County,Georgia,110527,33.5,82403,12108,53793,56734,"(33.583440000000003, -85.049940000000007)"
Catoosa County,Georgia,63942,38.299999999999997,48002,8656,31028,32914,"(34.900080000000003, -85.149950000000004)"
Charlton County,Georgia,12171,38.200000000000003,9529,1543,6847,5324,"(30.833559999999999, -82.133179999999996)"
Chatham County,Georgia,265128,34,205121,32864,127704,137424,"(32.001600000000003, -81.083169999999996)"
Chattahoochee County,Georgia,11267,24,8214,420,7039,4228,"(32.350149999999999, -84.783259999999999)"
Chattooga County,Georgia,26015,39.299999999999997,20157,3801,13513,12502,"(34.466749999999998, -85.333290000000005)"
Cherokee County,Georgia,214346,36.299999999999997,155426,19698,105874,108472,"(34.266759999999998, -84.449929999999995)"
Clarke County,Georgia,116714,25.9,96291,9952,55388,61326,"(33.950119999999998, -83.383210000000005)"
Clay County,Georgia,3183,45.8,2466,623,1462,1721,"(31.61683, -84.983260000000001)"
Clayton County,Georgia,259424,31.6,184445,17236,124232,135192,"(33.533450000000002, -84.366590000000002)"
Clinch County,Georgia,6798,36.799999999999997,4955,868,3315,3483,"(30.900210000000001, -82.733189999999993)"
Cobb County,Georgia,688078,35.4,511591,59972,334369,353709,"(33.933439999999997, -84.566599999999994)"
Coffee County,Georgia,42356,34.799999999999997,31255,4691,21455,20901,"(31.550190000000001, -82.849869999999996)"
Colquitt County,Georgia,45498,34.799999999999997,32914,5863,22576,22922,"(31.183520000000001, -83.766559999999998)"
Columbia County,Georgia,124053,36.799999999999997,90243,12700,60328,63725,"(33.550139999999999, -82.250399999999999)"
Cook County,Georgia,17212,36.4,12530,2320,8372,8840,"(31.16686, -83.449879999999993)"
Coweta County,Georgia,127317,36.6,92485,13240,62242,65075,"(33.383450000000003, -84.766599999999997)"
Crawford County,Georgia,12630,41.5,9762,1662,6381,6249,"(32.716810000000002, -84.004080000000002)"
Crisp County,Georgia,23439,38.1,17317,3273,11221,12218,"(31.933509999999998, -83.766559999999998)"
Dade County,Georgia,16633,39,13047,2397,8192,8441,"(34.86674, -85.500519999999995)"
Dawson County,Georgia,22330,40.6,17247,3132,11164,11166,"(34.433430000000001, -84.166579999999996)"
Decatur County,Georgia,27842,37.700000000000003,20760,3879,13605,14237,"(30.850190000000001, -84.583250000000007)"
DeKalb County,Georgia,691893,34.299999999999997,526757,62228,331355,360538,"(33.75038, -84.233249999999998)"
Dodge County,Georgia,21796,38.5,16719,3015,11449,10347,"(32.183509999999998, -83.166539999999998)"
Dooly County,Georgia,14918,40,11759,2055,8053,6865,"(32.150170000000003, -83.783230000000003)"
Dougherty County,Georgia,94565,33.200000000000003,70231,11457,43927,50638,"(31.53351, -84.199910000000003)"
Douglas County,Georgia,132403,35,94870,11244,63772,68631,"(33.700110000000002, -84.749939999999995)"
Early County,Georgia,11008,39.299999999999997,8107,1791,5191,5817,"(31.33351, -84.933260000000004)"
Echols County,Georgia,4034,31.4,2851,398,2040,1994,"(30.71688, -82.849860000000007)"
Effingham County,Georgia,52250,35.1,37344,4763,26017,26233,"(32.366860000000003, -81.333169999999996)"
Elbert County,Georgia,20166,41.1,15467,3390,9656,10510,"(34.116779999999999, -82.866529999999997)"
Emanuel County,Georgia,22598,36.799999999999997,16850,3162,11038,11560,"(32.583500000000001, -82.283180000000002)"
Evans County,Georgia,11000,35.9,8163,1505,5387,5613,"(32.16686, -81.883170000000007)"
Fannin County,Georgia,23682,48.3,19151,5197,11547,12135,"(34.883420000000001, -84.316590000000005)"
Fayette County,Georgia,106567,42.4,78468,13545,51505,55062,"(33.400120000000001, -84.483260000000001)"
Floyd County,Georgia,96317,37.6,72872,13702,46640,49677,"(34.266759999999998, -85.149950000000004)"
Forsyth County,Georgia,175511,36.9,122106,15638,87194,88317,"(34.216760000000001, -84.116579999999999)"
Franklin County,Georgia,22084,40.9,17128,3729,10911,11173,"(34.366770000000002, -83.199879999999993)"
Fulton County,Georgia,920581,34.200000000000003,700895,83424,448267,472314,"(33.766770000000001, -84.449929999999995)"
Gilmer County,Georgia,28292,43.4,22063,5015,14146,14146,"(34.683419999999998, -84.449929999999995)"
Glascock County,Georgia,3082,39.299999999999997,2269,465,1487,1595,"(33.216810000000002, -82.616519999999994)"
Glynn County,Georgia,79626,39.4,60395,11976,37855,41771,"(31.233560000000001, -81.533159999999995)"
Gordon County,Georgia,55186,36,40311,6423,27283,27903,"(34.500369999999997, -84.866609999999994)"
Grady County,Georgia,25011,37.799999999999997,18584,3536,12115,12896,"(30.866859999999999, -84.233239999999995)"
Greene County,Georgia,15994,46.4,12697,3358,7809,8185,"(33.583460000000002, -83.166539999999998)"
Gwinnett County,Georgia,805321,33.700000000000003,570614,55105,397153,408168,"(33.950099999999999, -84.049909999999997)"
Habersham County,Georgia,43041,38.6,32737,6599,20301,22740,"(34.616759999999999, -83.499889999999994)"
Hall County,Georgia,179684,34.5,129518,20010,89601,90083,"(34.316769999999998, -83.783230000000003)"
Hancock County,Georgia,9429,43,7710,1468,5170,4259,"(33.26681, -82.966539999999995)"
Haralson County,Georgia,28780,38.5,21547,4036,14072,14708,"(33.783439999999999, -85.199950000000001)"
Harris County,Georgia,32024,42,24406,4238,15975,16049,"(32.733469999999997, -84.899929999999998)"
Hart County,Georgia,25213,42.6,19602,4527,12455,12758,"(34.350099999999998, -82.966530000000006)"
Heard County,Georgia,11834,39.1,8786,1565,5885,5949,"(33.30012, -85.133279999999999)"
Henry County,Georgia,203922,35.299999999999997,144265,17048,97859,106063,"(33.450110000000002, -84.149919999999995)"
Houston County,Georgia,139900,34.5,102409,14571,68066,71834,"(32.433489999999999, -83.649900000000002)"
Irwin County,Georgia,9538,38.799999999999997,7223,1485,4804,4734,"(31.600190000000001, -83.299880000000002)"
Jackson County,Georgia,60485,37.1,44440,7197,30002,30483,"(34.13344, -83.566550000000007)"
Jasper County,Georgia,13900,39,10425,1764,6916,6984,"(33.333460000000002, -83.683229999999995)"
Jeff Davis County,Georgia,15068,36,10902,1874,7464,7604,"(31.800190000000001, -82.649860000000004)"
Jefferson County,Georgia,16930,38.799999999999997,12659,2498,8183,8747,"(33.050150000000002, -82.416520000000006)"
Jenkins County,Georgia,8340,38.200000000000003,6104,1256,3959,4381,"(32.783499999999997, -81.966499999999996)"
Johnson County,Georgia,9980,40.4,7890,1389,5592,4388,"(32.683500000000002, -82.666520000000006)"
Jones County,Georgia,28669,38.700000000000003,21196,3586,13870,14799,"(33.016800000000003, -83.533230000000003)"
Lamar County,Georgia,18317,37.700000000000003,14448,2487,8852,9465,"(33.066789999999997, -84.149919999999995)"
Lanier County,Georgia,10078,33.4,7310,1104,5084,4994,"(31.0502, -83.066540000000003)"
Laurens County,Georgia,48434,38,35959,6884,23066,25368,"(32.45017, -82.916529999999995)"
Lee County,Georgia,28298,36,20363,2354,14097,14201,"(31.766839999999998, -84.149910000000006)"
Liberty County,Georgia,63453,27.9,44262,3971,30962,32491,"(31.833539999999999, -81.500389999999996)"
Lincoln County,Georgia,7996,45,6345,1396,3896,4100,"(33.783459999999998, -82.466520000000003)"
Long County,Georgia,14464,30.6,10045,1055,7162,7302,"(31.733550000000001, -81.766499999999994)"
Lowndes County,Georgia,109233,29.9,82263,10693,53285,55948,"(30.833539999999999, -83.249870000000001)"
Lumpkin County,Georgia,29966,36.1,23725,3794,14894,15072,"(34.566760000000002, -84.016580000000005)"
McDuffie County,Georgia,21875,38.4,16177,2972,10250,11625,"(33.466799999999999, -82.449849999999998)"
McIntosh County,Georgia,14333,44.4,11255,2478,6989,7344,"(31.483560000000001, -81.416489999999996)"
Macon County,Georgia,14740,38.200000000000003,11487,1827,7973,6767,"(32.366819999999997, -84.033240000000006)"
Madison County,Georgia,28120,39.4,21246,3754,13898,14222,"(34.13344, -83.216539999999995)"
Marion County,Georgia,8742,40.799999999999997,6646,1215,4305,4437,"(32.350149999999999, -84.516589999999994)"
Meriwether County,Georgia,21992,41,16782,3467,10492,11500,"(33.050130000000003, -84.699929999999995)"
Miller County,Georgia,6125,41.7,4689,1123,2929,3196,"(31.150179999999999, -84.733249999999998)"
Mitchell County,Georgia,23498,37.1,17662,3087,12186,11312,"(31.216850000000001, -84.1999)"
Monroe County,Georgia,26424,41.3,20471,3669,13271,13153,"(33.001519999999999, -83.883240000000001)"
Montgomery County,Georgia,9123,37,7039,1173,4695,4428,"(32.166849999999997, -82.533190000000005)"
Morgan County,Georgia,17868,41.3,13429,2774,8636,9232,"(33.583460000000002, -83.383219999999994)"
Murray County,Georgia,39628,36.200000000000003,28980,4286,19652,19976,"(34.800080000000001, -84.750219999999999)"
Muscogee County,Georgia,189885,33.5,141287,22082,90870,99015,"(32.500700000000002, -84.866600000000005)"
Newton County,Georgia,99958,34.700000000000003,71085,9830,47626,52332,"(33.55012, -83.849900000000005)"
Oconee County,Georgia,32808,39.1,23505,3578,16007,16801,"(33.833449999999999, -83.433220000000006)"
Oglethorpe County,Georgia,14899,40.1,11344,2114,7385,7514,"(33.866790000000002, -83.083209999999994)"
Paulding County,Georgia,142324,33.799999999999997,99230,10220,69578,72746,"(33.933439999999997, -84.866609999999994)"
Peach County,Georgia,27695,33.299999999999997,21375,3164,13416,14279,"(32.566809999999997, -83.833240000000004)"
Pickens County,Georgia,29431,42.1,22794,4805,14440,14991,"(34.466760000000001, -84.449929999999995)"
Pierce County,Georgia,18758,38.4,13862,2631,9202,9556,"(31.35022, -82.21651)"
Pike County,Georgia,17869,38.5,13031,2196,8742,9127,"(33.083460000000002, -84.383260000000007)"
Polk County,Georgia,41475,36.200000000000003,30429,5535,20518,20957,"(34.001489999999997, -85.183279999999996)"
Pulaski County,Georgia,12010,41.1,9432,1882,5191,6819,"(32.233499999999999, -83.466560000000001)"
Putnam County,Georgia,21218,43.5,16617,3845,10331,10887,"(33.333469999999998, -83.349879999999999)"
Quitman County,Georgia,2513,46.4,1999,554,1200,1313,"(31.86683, -85.016589999999994)"
Rabun County,Georgia,16276,45.8,12847,3459,8025,8251,"(34.883429999999997, -83.399879999999996)"
Randolph County,Georgia,7719,42.8,5991,1376,3552,4167,"(31.750160000000001, -84.766589999999994)"
Richmond County,Georgia,200549,33.200000000000003,151244,22712,97015,103534,"(33.366810000000001, -82.09984)"
Rockdale County,Georgia,85215,36.9,62301,9066,40533,44682,"(33.650109999999998, -84.016580000000005)"
Schley County,Georgia,5010,37.1,3507,657,2407,2603,"(32.266820000000003, -84.299909999999997)"
Screven County,Georgia,14593,39.5,10903,2174,7116,7477,"(32.750720000000001, -81.633160000000004)"
Seminole County,Georgia,8729,43.7,6725,1657,4139,4590,"(30.933520000000001, -84.866590000000002)"
Spalding County,Georgia,64073,37.200000000000003,47862,8539,31046,33027,"(33.266779999999997, -84.283259999999999)"
Stephens County,Georgia,26175,40.700000000000003,20223,4348,12528,13647,"(34.5501, -83.266549999999995)"
Stewart County,Georgia,6058,37.299999999999997,5109,858,3682,2376,"(32.06682, -84.849919999999997)"
Sumter County,Georgia,32819,33.799999999999997,24518,4143,15627,17192,"(32.050170000000001, -84.183239999999998)"
Talbot County,Georgia,6865,45.6,5401,1119,3245,3620,"(32.700139999999998, -84.499920000000003)"
Taliaferro County,Georgia,1717,45.9,1394,352,841,876,"(33.583460000000002, -82.916539999999998)"
Tattnall County,Georgia,25520,36.6,20114,2971,14860,10660,"(32.050199999999997, -82.049840000000003)"
Taylor County,Georgia,8906,39.700000000000003,6728,1330,4301,4605,"(32.566809999999997, -84.250190000000003)"
Telfair County,Georgia,16500,39.200000000000003,13184,2251,9452,7048,"(31.95018, -82.933199999999999)"
Terrell County,Georgia,9315,39.6,7011,1388,4479,4836,"(31.7835, -84.449920000000006)"
Thomas County,Georgia,44720,39.6,33583,6740,21179,23541,"(30.950189999999999, -83.866560000000007)"
Tift County,Georgia,40118,34.5,29758,5123,19210,20908,"(31.450189999999999, -83.500159999999994)"
Toombs County,Georgia,27223,36,19608,3742,12928,14295,"(32.133519999999997, -82.333179999999999)"
Towns County,Georgia,10471,51.1,8830,3061,4996,5475,"(34.900089999999999, -83.716560000000001)"
Treutlen County,Georgia,6885,36.799999999999997,5172,940,3449,3436,"(32.416840000000001, -82.549850000000006)"
Troup County,Georgia,67044,36.299999999999997,49242,8303,32215,34829,"(33.033459999999998, -85.033270000000002)"
Turner County,Georgia,8930,38.700000000000003,6727,1401,4358,4572,"(31.70018, -83.616560000000007)"
Twiggs County,Georgia,9023,45,7167,1459,4398,4625,"(32.683480000000003, -83.416560000000004)"
Union County,Georgia,21356,50.7,17563,5675,10397,10959,"(34.833419999999997, -83.966579999999993)"
Upson County,Georgia,27153,40.299999999999997,20736,4252,13024,14129,"(32.866799999999998, -84.316590000000005)"
Walker County,Georgia,68756,39.700000000000003,52500,10302,33781,34975,"(34.750079999999997, -85.299959999999999)"
Walton County,Georgia,83768,37.4,61180,10092,40763,43005,"(33.766779999999997, -83.733230000000006)"
Ware County,Georgia,36312,38.4,27755,5531,18069,18243,"(31.083549999999999, -82.499859999999998)"
Warren County,Georgia,5834,42.9,4461,1047,2694,3140,"(33.43347, -82.683189999999996)"
Washington County,Georgia,21187,38.9,16141,2881,10812,10375,"(33.000430000000001, -82.799859999999995)"
Wayne County,Georgia,30099,37.6,22638,3862,15719,14380,"(31.566880000000001, -81.899839999999998)"
Webster County,Georgia,2799,40.6,2089,420,1362,1437,"(32.050159999999998, -84.533249999999995)"
Wheeler County,Georgia,7421,37.9,6022,882,4580,2841,"(32.116840000000003, -82.750420000000005)"
White County,Georgia,27144,42.3,20944,4754,13269,13875,"(34.650100000000002, -83.749899999999997)"
Whitfield County,Georgia,102599,34,73316,11445,51118,51481,"(34.833410000000001, -84.966610000000003)"
Wilcox County,Georgia,9255,39.700000000000003,7468,1321,5436,3819,"(31.966840000000001, -83.449889999999996)"
Wilkes County,Georgia,10593,43.4,8237,1971,5169,5424,"(33.800130000000003, -82.766530000000003)"
Wilkinson County,Georgia,9563,41.1,7239,1504,4582,4981,"(32.81682, -83.166539999999998)"
Worth County,Georgia,21679,39.700000000000003,16336,3134,10397,11282,"(31.53351, -83.83323)"
Hawaii County,Hawaii,185079,40.9,142799,26834,92821,92258,"(19.50056, -155.50056000000001)"
Honolulu County,Hawaii,953207,37.799999999999997,742707,138490,477092,476115,"(21.466670000000001, -157.96666999999999)"
Kalawao County,Hawaii,90,55.3,90,26,42,48,"(21.18806, -156.96666999999999)"
Kauai County,Hawaii,67091,41.3,51868,9985,33701,33390,"(22.05, -159.50056000000001)"
Maui County,Hawaii,154834,39.6,119019,19803,77587,77247,"(20.866669999999999, -156.50056000000001)"
Ada County,Idaho,392365,34.799999999999997,288659,41048,196501,195864,"(43.416559999999997, -116.12622)"
Adams County,Idaho,3976,50,3213,828,2041,1935,"(45.252659999999999, -116.62875)"
Bannock County,Idaho,82839,31.4,60125,9243,41298,41541,"(42.650750000000002, -112.21219000000001)"
Bear Lake County,Idaho,5986,40.5,4350,1104,2972,3014,"(42.312429999999999, -111.31354)"
Benewah County,Idaho,9285,44.8,7084,1699,4732,4553,"(47.208240000000004, -116.62627999999999)"
Bingham County,Idaho,45607,31.8,30559,5214,22885,22722,"(43.174079999999996, -112.31164)"
Blaine County,Idaho,21376,40.4,16173,2476,10886,10490,"(43.91657, -114.87618000000001)"
Boise County,Idaho,7028,48.4,5519,1118,3671,3357,"(44.29157, -115.37622)"
Bonner County,Idaho,40877,45.8,32027,7009,20592,20285,"(48.833260000000003, -117.00134)"
Bonneville County,Idaho,104234,31.7,71440,11343,51996,52238,"(43.416580000000003, -111.50106)"
Boundary County,Idaho,10972,42.8,8160,1832,5549,5423,"(48.958260000000003, -117.00135)"
Butte County,Idaho,2891,41.7,2076,506,1485,1406,"(44.166580000000003, -113.37612)"
Camas County,Idaho,1117,44.3,877,178,582,535,"(43.438789999999997, -114.81201)"
Canyon County,Idaho,188923,31.6,129431,20396,93506,95417,"(43.875160000000001, -116.95932000000001)"
Caribou County,Idaho,6963,37.700000000000003,4947,1103,3509,3454,"(42.745480000000001, -111.57856)"
Cassia County,Idaho,22952,32,15365,2954,11612,11340,"(42.31908, -113.56362)"
Clark County,Idaho,982,32.700000000000003,674,129,543,439,"(44.500190000000003, -112.70917)"
Clearwater County,Idaho,8761,49,7205,1960,4739,4022,"(46.541580000000003, -115.37624)"
Custer County,Idaho,4368,48,3510,818,2318,2050,"(44.8752, -114.22174)"
Elmore County,Idaho,27038,30,19363,2716,13971,13067,"(43.31212, -115.43868999999999)"
Franklin County,Idaho,12786,31.5,8288,1643,6486,6300,"(42.185200000000002, -111.81662)"
Fremont County,Idaho,13242,33.5,9088,1844,6963,6279,"(44.7502, -111.37607)"
Gem County,Idaho,16719,42.9,12621,3107,8283,8436,"(44.500169999999997, -116.20931)"
Gooding County,Idaho,15464,34.299999999999997,10901,2328,7999,7465,"(42.91657, -114.75116)"
Idaho County,Idaho,16267,48,12862,3444,8492,7775,"(45.95825, -114.62621)"
Jefferson County,Idaho,26140,30,16853,2504,13114,13026,"(44.04157, -112.62609999999999)"
Jerome County,Idaho,22374,31.7,15426,2507,11429,10945,"(42.79157, -114.50115)"
Kootenai County,Idaho,138494,38.9,104250,20078,68257,70237,"(47.708240000000004, -116.6263)"
Latah County,Idaho,37244,28.3,30275,3858,19163,18081,"(47.125169999999997, -117.00127999999999)"
Lemhi County,Idaho,7936,49.7,6360,1758,4049,3887,"(45.666589999999999, -114.00118999999999)"
Lewis County,Idaho,3821,48,2973,834,1916,1905,"(46.166550000000001, -116.62626)"
Lincoln County,Idaho,5208,32,3509,573,2691,2517,"(43.02046, -114.10420000000001)"
Madison County,Idaho,37536,22.6,27788,2092,18186,19350,"(43.916580000000003, -111.87608)"
Minidoka County,Idaho,20069,35.299999999999997,14176,2969,10154,9915,"(43.16657, -113.62613)"
Nez Perce County,Idaho,39265,40.799999999999997,30750,7063,19468,19797,"(46.625169999999997, -116.62626)"
Oneida County,Idaho,4286,39.1,3003,714,2191,2095,"(42.234920000000002, -112.50386)"
Owyhee County,Idaho,11526,36,8157,1612,5895,5631,"(42.559620000000002, -116.06177)"
Payette County,Idaho,22623,37.200000000000003,16139,3462,11191,11432,"(44.127659999999999, -116.87877)"
Power County,Idaho,7817,33.200000000000003,5403,947,4025,3792,"(42.693249999999999, -112.81832)"
Shoshone County,Idaho,12765,46.2,10105,2537,6424,6341,"(47.333260000000003, -115.96766)"
Teton County,Idaho,10170,33.200000000000003,7147,664,5321,4849,"(43.916580000000003, -111.37606)"
Twin Falls County,Idaho,77230,34.4,56086,10706,38115,39115,"(42.350459999999998, -114.64449)"
Valley County,Idaho,9862,46.9,7913,1659,5107,4755,"(45.127670000000002, -116.12624)"
Washington County,Idaho,10198,43.6,7680,2091,5017,5181,"(44.750160000000001, -117.00127999999999)"
Adams County,Illinois,67103,40.700000000000003,51642,11747,32667,34436,"(39.966709999999999, -91.18347)"
Alexander County,Illinois,8238,41.1,6353,1397,4182,4056,"(37.18338, -89.183409999999995)"
Bond County,Illinois,17768,39.700000000000003,14118,2671,9284,8484,"(38.883380000000002, -89.433409999999995)"
Boone County,Illinois,54165,36.799999999999997,38481,6364,27059,27106,"(42.333350000000003, -88.816770000000005)"
Brown County,Illinois,6937,37.299999999999997,5823,859,4450,2487,"(39.966720000000002, -90.733459999999994)"
Bureau County,Illinois,34978,42.5,26823,6326,17119,17859,"(41.400039999999997, -89.516760000000005)"
Calhoun County,Illinois,5089,44.6,3976,1024,2528,2561,"(39.166710000000002, -90.650120000000001)"
Carroll County,Illinois,15387,46.5,12226,3262,7708,7679,"(42.066690000000001, -89.916790000000006)"
Cass County,Illinois,13642,38.700000000000003,10241,2142,6838,6804,"(39.950049999999997, -90.233450000000005)"
Champaign County,Illinois,201081,28.9,162002,20066,100390,100691,"(40.133369999999999, -88.200050000000005)"
Christian County,Illinois,34800,41.6,27024,6096,17654,17146,"(39.550049999999999, -89.283420000000007)"
Clark County,Illinois,16335,42.3,12617,2946,7962,8373,"(39.333370000000002, -87.800030000000007)"
Clay County,Illinois,13815,42.2,10651,2468,6781,7034,"(38.833379999999998, -88.483379999999997)"
Clinton County,Illinois,37762,39.299999999999997,29180,5458,19529,18233,"(38.600050000000003, -89.400080000000003)"
Coles County,Illinois,53873,31.6,43931,7431,25958,27915,"(39.55003, -88.233379999999997)"
Cook County,Illinois,5194675,35.299999999999997,3962395,620329,2514314,2680361,"(41.833359999999999, -87.850059999999999)"
Crawford County,Illinois,19817,41.7,15764,3336,10287,9530,"(39.016710000000003, -87.766689999999997)"
Cumberland County,Illinois,11048,40.9,8450,1838,5517,5531,"(39.2667, -88.250600000000006)"
DeKalb County,Illinois,105160,29.3,81670,10337,52530,52630,"(41.916699999999999, -88.750360000000001)"
De Witt County,Illinois,16561,41.7,12739,2768,8201,8360,"(40.166699999999999, -88.916749999999993)"
Douglas County,Illinois,19980,38.700000000000003,14806,3154,9847,10133,"(39.7667, -88.216710000000006)"
DuPage County,Illinois,916924,38.200000000000003,689494,106398,449351,467573,"(41.833359999999999, -88.083399999999997)"
Edgar County,Illinois,18576,43.2,14455,3469,9008,9568,"(39.666699999999999, -87.750579999999999)"
Edwards County,Illinois,6721,42.7,5185,1191,3318,3403,"(38.416719999999998, -88.050039999999996)"
Effingham County,Illinois,34242,39.200000000000003,25800,5196,17009,17233,"(39.050040000000003, -88.583380000000005)"
Fayette County,Illinois,22140,39.9,17164,3580,11644,10496,"(39.016710000000003, -89.0334)"
Ford County,Illinois,14081,42.4,10734,2633,6854,7227,"(40.583370000000002, -88.250609999999995)"
Franklin County,Illinois,39561,41.8,30600,7278,19342,20219,"(38.000610000000002, -88.933400000000006)"
Fulton County,Illinois,37069,41.9,29316,6692,19153,17916,"(40.466709999999999, -90.183449999999993)"
Gallatin County,Illinois,5589,44.4,4405,1145,2724,2865,"(37.766710000000003, -88.233369999999994)"
Greene County,Illinois,13886,41.6,10688,2388,7014,6872,"(39.350050000000003, -90.400120000000001)"
Grundy County,Illinois,50063,36.1,36406,5546,24977,25086,"(41.283369999999998, -88.416730000000001)"
Hamilton County,Illinois,8457,43.1,6526,1671,4131,4326,"(38.06671, -88.550049999999999)"
Hancock County,Illinois,19104,44.6,14907,3786,9390,9714,"(40.516710000000003, -91.150139999999993)"
Hardin County,Illinois,4320,46.3,3444,878,2147,2173,"(37.516669999999998, -88.266670000000005)"
Henderson County,Illinois,7331,47.2,5838,1532,3614,3717,"(40.81671, -90.900139999999993)"
Henry County,Illinois,50486,41.8,38391,8624,25112,25374,"(41.35004, -90.150120000000001)"
Iroquois County,Illinois,29718,43.4,22703,5627,14519,15199,"(40.750590000000003, -87.833370000000002)"
Jackson County,Illinois,60218,29.1,49480,7002,30676,29542,"(37.766719999999999, -89.350089999999994)"
Jasper County,Illinois,9698,42.7,7494,1689,4832,4866,"(39.000599999999999, -88.166709999999995)"
Jefferson County,Illinois,38827,40.6,30231,6288,19945,18882,"(38.300049999999999, -88.933400000000006)"
Jersey County,Illinois,22985,40.5,17746,3605,11255,11730,"(39.06671, -90.350110000000001)"
Jo Daviess County,Illinois,22678,47.1,17963,4832,11377,11301,"(42.350009999999997, -90.183459999999997)"
Johnson County,Illinois,12582,42.2,10141,2167,7018,5564,"(37.450049999999997, -88.866730000000004)"
Kane County,Illinois,515269,34.5,366079,49690,256815,258454,"(41.950029999999998, -88.433409999999995)"
Kankakee County,Illinois,113449,36.700000000000003,84695,15237,55731,57718,"(41.150030000000001, -87.866709999999998)"
Kendall County,Illinois,114736,32.9,78670,8382,56821,57915,"(41.583359999999999, -88.433400000000006)"
Knox County,Illinois,52919,42,42039,9762,26582,26337,"(40.933369999999996, -90.200119999999998)"
Lake County,Illinois,703462,36.700000000000003,510790,73093,351119,352343,"(42.333359999999999, -88.000630000000001)"
LaSalle County,Illinois,113924,41,87706,18678,56872,57052,"(41.2667, -88.883409999999998)"
Lawrence County,Illinois,16833,39.700000000000003,13626,2683,9423,7410,"(38.700049999999997, -87.71669)"
Lee County,Illinois,36031,42,28297,5644,18910,17121,"(41.750590000000003, -89.283429999999996)"
Livingston County,Illinois,38950,40.799999999999997,30192,6142,19526,19424,"(40.866700000000002, -88.516720000000007)"
Logan County,Illinois,30305,39.4,24243,4760,15368,14937,"(40.133380000000002, -89.366759999999999)"
McDonough County,Illinois,32612,28.9,27369,4644,16330,16282,"(40.466709999999999, -90.666799999999995)"
McHenry County,Illinois,308760,38,224585,31320,153936,154824,"(42.333350000000003, -88.466759999999994)"
McLean County,Illinois,169572,32.1,131160,17340,82329,87243,"(40.483370000000001, -88.833399999999997)"
Macon County,Illinois,110768,40.299999999999997,85484,18142,52950,57818,"(39.866700000000002, -88.966750000000005)"
Macoupin County,Illinois,47765,41.7,36990,8171,23548,24217,"(39.266710000000003, -89.933440000000004)"
Madison County,Illinois,269282,38.6,208036,38428,131578,137704,"(38.833379999999998, -89.900099999999995)"
Marion County,Illinois,39437,41.4,30199,6923,19181,20256,"(38.65005, -88.933390000000003)"
Marshall County,Illinois,12640,44.8,9898,2468,6226,6414,"(41.033369999999998, -89.366759999999999)"
Mason County,Illinois,14666,44,11439,2805,7198,7468,"(40.250599999999999, -89.883449999999996)"
Massac County,Illinois,15429,42.1,11911,2838,7374,8055,"(37.23339, -88.73339)"
Menard County,Illinois,12705,42.6,9704,1978,6181,6524,"(40.016719999999999, -89.783439999999999)"
Mercer County,Illinois,16434,43.7,12714,3001,8125,8309,"(41.200029999999998, -90.750699999999995)"
Monroe County,Illinois,32957,41,24886,4658,16282,16675,"(38.283389999999997, -90.183449999999993)"
Montgomery County,Illinois,30104,41.9,23718,5199,15745,14359,"(39.233379999999997, -89.450090000000003)"
Morgan County,Illinois,35547,40.799999999999997,27960,5935,17861,17686,"(39.716709999999999, -90.216790000000003)"
Moultrie County,Illinois,14846,40.299999999999997,11145,2618,7212,7634,"(39.633369999999999, -88.633399999999995)"
Ogle County,Illinois,53497,40.700000000000003,40253,8122,26523,26974,"(42.033360000000002, -89.316770000000005)"
Peoria County,Illinois,186494,36.799999999999997,141601,25963,90247,96247,"(40.7667, -89.766769999999994)"
Perry County,Illinois,22350,39.4,17717,3515,12114,10236,"(38.083379999999998, -89.366749999999996)"
Piatt County,Illinois,16729,42.6,12722,2713,8271,8458,"(40.000590000000003, -88.583399999999997)"
Pike County,Illinois,16430,42.5,12718,3136,8198,8232,"(39.600050000000003, -90.816800000000001)"
Pope County,Illinois,4470,46.6,3656,965,2356,2114,"(37.416719999999998, -88.56671)"
Pulaski County,Illinois,6161,43.2,4756,1124,2943,3218,"(37.216720000000002, -89.150080000000003)"
Putnam County,Illinois,6006,45.2,4727,1069,3035,2971,"(41.200040000000001, -89.283420000000007)"
Randolph County,Illinois,33476,41,26845,5340,18378,15098,"(38.066719999999997, -89.850099999999998)"
Richland County,Illinois,16233,42.1,12625,3110,7957,8276,"(38.716709999999999, -88.100040000000007)"
Rock Island County,Illinois,147546,40,114359,23881,72375,75171,"(41.450029999999998, -90.516800000000003)"
St. Clair County,Illinois,270056,36.9,201468,33810,129976,140080,"(39.400039999999997, -88.7834)"
Saline County,Illinois,24913,41.7,19209,4585,12170,12743,"(37.766710000000003, -88.550049999999999)"
Sangamon County,Illinois,197465,39.200000000000003,150649,27362,94780,102685,"(39.766719999999999, -89.650099999999995)"
Schuyler County,Illinois,7544,43.6,5964,1398,3933,3611,"(40.15005, -90.600129999999993)"
Scott County,Illinois,5355,42.7,4083,966,2619,2736,"(39.65005, -90.466790000000003)"
Shelby County,Illinois,22363,43.5,17311,4232,11138,11225,"(39.400039999999997, -88.7834)"
Stark County,Illinois,5994,43.8,4583,1194,2923,3071,"(41.10004, -89.8001)"
Stephenson County,Illinois,47711,43.1,36900,8958,23146,24565,"(42.350020000000001, -89.666780000000003)"
Tazewell County,Illinois,135394,39.799999999999997,103558,21139,66719,68675,"(40.533369999999998, -89.5501)"
Union County,Illinois,17808,42.9,13980,3235,8882,8926,"(37.450049999999997, -89.250640000000004)"
Vermilion County,Illinois,81625,39.799999999999997,61697,13302,40470,41155,"(40.166699999999999, -87.750579999999999)"
Wabash County,Illinois,11947,42,9299,2132,5846,6101,"(38.450049999999997, -87.850030000000004)"
Warren County,Illinois,17707,39.6,13788,3016,8601,9106,"(40.85004, -90.616799999999998)"
Washington County,Illinois,14716,42.3,11458,2503,7373,7343,"(38.350050000000003, -89.433419999999998)"
Wayne County,Illinois,16760,42.9,12980,3259,8258,8502,"(38.43338, -88.416709999999995)"
White County,Illinois,14665,45.2,11600,3074,7085,7580,"(38.083379999999998, -88.166700000000006)"
Whiteside County,Illinois,58498,41.8,44758,10247,28715,29783,"(41.750590000000003, -89.916780000000003)"
Will County,Illinois,677560,35.4,480606,62814,336556,341004,"(41.433369999999996, -87.966719999999995)"
Williamson County,Illinois,66357,40.1,51665,10837,32824,33533,"(37.733379999999997, -88.933400000000006)"
Winnebago County,Illinois,295266,38.299999999999997,221686,40715,144327,150939,"(42.350020000000001, -89.183440000000004)"
Woodford County,Illinois,38664,39.6,28674,5722,19100,19564,"(40.7667, -89.233419999999995)"
Adams County,Indiana,34387,34,23673,4750,16999,17388,"(40.745049999999999, -84.936909999999997)"
Allen County,Indiana,355329,35.299999999999997,259371,42137,173221,182108,"(41.070599999999999, -85.014409999999998)"
Bartholomew County,Indiana,76794,38.200000000000003,57434,10731,37936,38858,"(39.201439999999998, -85.921379999999999)"
Benton County,Indiana,8854,40.1,6570,1394,4385,4469,"(40.616700000000002, -87.320849999999993)"
Blackford County,Indiana,12766,42.4,9852,2268,6292,6474,"(40.451149999999998, -85.369969999999995)"
Boone County,Indiana,56640,38.6,40723,6644,27864,28776,"(40.048369999999998, -86.469170000000005)"
Brown County,Indiana,15242,46.7,12070,2620,7565,7677,"(39.207270000000001, -86.251099999999994)"
Carroll County,Indiana,20155,40.9,15198,3182,10100,10055,"(40.547260000000001, -86.524439999999998)"
Cass County,Indiana,38966,38.700000000000003,28873,5874,19478,19488,"(40.754480000000001, -86.356669999999994)"
Clark County,Indiana,110232,37.9,84123,14055,53979,56253,"(38.483400000000003, -85.761349999999993)"
Clay County,Indiana,26890,39.9,20449,4051,13234,13656,"(39.416989999999998, -87.077240000000003)"
Clinton County,Indiana,33224,37.5,24375,4776,16426,16798,"(40.27948, -86.510840000000002)"
Crawford County,Indiana,10713,41.8,8218,1608,5436,5277,"(38.334499999999998, -86.464150000000004)"
Daviess County,Indiana,31648,35.4,22528,4461,15770,15878,"(38.662550000000003, -87.046120000000002)"
Dearborn County,Indiana,50047,40,37532,6567,24870,25177,"(39.168109999999999, -84.911900000000003)"
Decatur County,Indiana,25740,38.700000000000003,19180,3717,12750,12990,"(39.337269999999997, -85.483580000000003)"
DeKalb County,Indiana,42223,38.1,31087,5540,20942,21281,"(41.366990000000001, -85.058859999999996)"
Delaware County,Indiana,117671,34.799999999999997,94098,17277,56606,61065,"(40.193379999999998, -85.386359999999996)"
Dubois County,Indiana,41889,39.9,31220,6079,20625,21264,"(38.346440000000001, -86.889719999999997)"
Elkhart County,Indiana,197559,34.9,141384,23962,97458,100101,"(41.582270000000001, -85.834440000000001)"
Fayette County,Indiana,24277,40.799999999999997,18459,4044,11891,12386,"(39.751440000000002, -85.251350000000002)"
Floyd County,Indiana,74578,39.1,56647,9660,36136,38442,"(38.324509999999997, -85.873580000000004)"
Fountain County,Indiana,17240,41.6,13066,3043,8534,8706,"(40.11309, -87.262510000000006)"
Franklin County,Indiana,23087,40,17054,3261,11540,11547,"(39.423110000000001, -85.012739999999994)"
Fulton County,Indiana,20836,40.299999999999997,15673,3428,10359,10477,"(41.06476, -86.215829999999997)"
Gibson County,Indiana,33503,39.9,25358,5122,16576,16927,"(38.355319999999999, -87.567520000000002)"
Grant County,Indiana,70061,39.5,54892,11373,33687,36374,"(40.558369999999996, -85.659139999999994)"
Greene County,Indiana,33165,41.1,25282,5317,16557,16608,"(39.026989999999998, -86.937510000000003)"
Hamilton County,Indiana,274569,35.6,191631,23689,133988,140581,"(40.045589999999997, -86.008600000000001)"
Hancock County,Indiana,70002,39.1,51664,8937,34386,35616,"(39.785040000000002, -85.769419999999997)"
Harrison County,Indiana,39364,40.200000000000003,30057,5451,19680,19684,"(38.212009999999999, -86.121920000000003)"
Hendricks County,Indiana,145448,36.700000000000003,105540,15569,72494,72954,"(39.760599999999997, -86.526390000000006)"
Henry County,Indiana,49462,41.4,38418,8001,25087,24375,"(39.928939999999997, -85.370249999999999)"
Howard County,Indiana,82752,40.700000000000003,63167,13441,39787,42965,"(40.486429999999999, -86.133600000000001)"
Huntington County,Indiana,37124,39,28329,5466,18239,18885,"(40.883099999999999, -85.497479999999996)"
Jackson County,Indiana,42376,38.700000000000003,31960,6068,21093,21283,"(38.87894, -86.041920000000005)"
Jasper County,Indiana,33478,38,24884,4702,16666,16812,"(41.041429999999998, -87.151409999999998)"
Jay County,Indiana,21253,39,15609,3267,10486,10767,"(40.434489999999997, -84.97775)"
Jefferson County,Indiana,32428,39.700000000000003,25094,4742,15634,16794,"(38.8095, -85.453569999999999)"
Jennings County,Indiana,28525,38.4,20995,3601,14288,14237,"(38.984780000000001, -85.609409999999997)"
Johnson County,Indiana,139654,36.799999999999997,102754,17174,68697,70957,"(39.480609999999999, -86.054990000000004)"
Knox County,Indiana,38440,38.5,30248,6062,19338,19102,"(38.75949, -87.415570000000002)"
Kosciusko County,Indiana,77358,37.700000000000003,57541,10473,38466,38892,"(41.238100000000003, -85.853049999999996)"
LaGrange County,Indiana,37128,30.4,24322,4292,18728,18400,"(41.641719999999999, -85.416650000000004)"
Lake County,Indiana,496005,37.4,368732,65870,239383,256622,"(41.416980000000002, -87.365309999999994)"
LaPorte County,Indiana,111467,39.6,86085,15867,57641,53826,"(41.610599999999998, -86.722520000000003)"
Lawrence County,Indiana,46134,41.6,35262,7562,22803,23331,"(38.861159999999998, -86.487210000000005)"
Madison County,Indiana,131636,39.200000000000003,101247,20234,65766,65870,"(40.193649999999998, -85.681640000000002)"
Marion County,Indiana,903393,33.9,676888,96102,435687,467706,"(39.768380000000001, -86.155540000000002)"
Marshall County,Indiana,47051,38.4,34402,6904,23282,23769,"(41.34366, -86.309730000000002)"
Martin County,Indiana,10334,41.8,7853,1625,5223,5111,"(38.666440000000001, -86.791110000000003)"
Miami County,Indiana,36903,39.5,28510,5148,19687,17216,"(40.75365, -86.068879999999993)"
Monroe County,Indiana,137974,27.7,115503,14047,68840,69134,"(39.165320000000001, -86.526390000000006)"
Montgomery County,Indiana,38124,39.4,28985,5928,19205,18919,"(40.041150000000002, -86.874449999999996)"
Morgan County,Indiana,68894,39.9,51566,8919,34164,34730,"(39.42783, -86.428330000000003)"
Newton County,Indiana,14244,42.4,10965,2370,7194,7050,"(41.013919999999999, -87.449200000000005)"
Noble County,Indiana,47536,37.1,34686,5941,23785,23751,"(41.395600000000002, -85.424419999999998)"
Ohio County,Indiana,6128,43.7,4828,1019,3033,3095,"(38.948950000000004, -84.853840000000005)"
Orange County,Indiana,19840,40.799999999999997,14953,3132,9861,9979,"(38.556170000000002, -86.468320000000006)"
Owen County,Indiana,21575,42.4,16564,3192,10818,10757,"(39.312539999999998, -86.866119999999995)"
Parke County,Indiana,17339,41.3,13626,2709,8123,9216,"(39.762540000000001, -87.229179999999999)"
Perry County,Indiana,19338,40.4,15195,2935,10249,9089,"(38.103949999999998, -86.583320000000001)"
Pike County,Indiana,12845,42.8,9965,2175,6419,6426,"(38.382269999999998, -87.212789999999998)"
Porter County,Indiana,164343,38.4,124422,20363,80764,83579,"(41.473089999999999, -87.061139999999995)"
Posey County,Indiana,25910,41.6,19772,3731,12893,13017,"(38.043379999999999, -87.839190000000002)"
Pulaski County,Indiana,13402,41.7,10204,2244,6767,6635,"(41.051430000000003, -86.603059999999999)"
Putnam County,Indiana,37963,37.9,29967,5131,20051,17912,"(39.644489999999998, -86.864729999999994)"
Randolph County,Indiana,26171,40.799999999999997,19788,4475,12910,13261,"(40.171990000000001, -84.981350000000006)"
Ripley County,Indiana,28818,39.200000000000003,21228,4281,14215,14603,"(39.072000000000003, -85.251900000000006)"
Rush County,Indiana,17392,40.6,13085,2741,8577,8815,"(39.609209999999997, -85.446359999999999)"
St. Joseph County,Indiana,266931,36.200000000000003,201080,35565,129412,137519,"(38.014769999999999, -87.036389999999997)"
Scott County,Indiana,24181,39.299999999999997,18369,3245,11951,12230,"(38.685609999999997, -85.770250000000004)"
Shelby County,Indiana,44436,39.9,33591,6188,22020,22416,"(39.521439999999998, -85.776920000000004)"
Spencer County,Indiana,20952,41.9,15889,3145,10542,10410,"(38.014769999999999, -87.036389999999997)"
Starke County,Indiana,23363,40.4,17667,3575,11536,11827,"(41.295879999999997, -86.625010000000003)"
Steuben County,Indiana,34185,40.200000000000003,26350,5090,17250,16935,"(41.634770000000003, -84.999409999999997)"
Sullivan County,Indiana,21475,39.799999999999997,16885,3186,11668,9807,"(39.095320000000001, -87.405850000000001)"
Switzerland County,Indiana,10613,39.1,7891,1549,5412,5201,"(38.836449999999999, -85.03134)"
Tippecanoe County,Indiana,172780,27.7,137063,16379,88040,84740,"(40.417259999999999, -86.890559999999994)"
Tipton County,Indiana,15936,42.6,12233,2738,7846,8090,"(40.282260000000001, -86.0411)"
Union County,Indiana,7516,40.299999999999997,5631,1087,3714,3802,"(39.635599999999997, -84.931070000000005)"
Vanderburgh County,Indiana,179703,37.5,139807,25896,86671,93032,"(38.082819999999998, -87.550569999999993)"
Vermillion County,Indiana,16212,41.9,12468,2736,8021,8191,"(39.8842, -87.408630000000002)"
Vigo County,Indiana,107848,36.1,84799,14511,54545,53303,"(39.466700000000003, -87.413910000000001)"
Wabash County,Indiana,32888,41.2,25429,5952,15974,16914,"(40.854489999999998, -85.791650000000004)"
Warren County,Indiana,8508,42.4,6512,1412,4269,4239,"(40.28837, -87.293899999999994)"
Warrick County,Indiana,59689,39.700000000000003,44258,7958,29402,30287,"(38.049210000000002, -87.274169999999998)"
Washington County,Indiana,28262,39.200000000000003,21136,3827,14113,14149,"(38.605609999999999, -86.099980000000002)"
Wayne County,Indiana,68917,40.200000000000003,53034,11329,33463,35454,"(39.817819999999998, -84.996350000000007)"
Wells County,Indiana,27636,40.200000000000003,20737,4340,13602,14034,"(40.738660000000003, -85.171639999999996)"
White County,Indiana,24643,41.9,18683,4230,12120,12523,"(40.749479999999998, -86.871679999999998)"
Whitley County,Indiana,33292,40.1,25109,4649,16553,16739,"(41.157269999999997, -85.488309999999998)"
Adair County,Iowa,7682,45.3,5957,1644,3807,3875,"(41.333320000000001, -94.466909999999999)"
Adams County,Iowa,4029,46.7,3180,860,1994,2035,"(41.033320000000003, -94.700249999999997)"
Allamakee County,Iowa,14330,44,11020,2803,7310,7020,"(43.28331, -91.366799999999998)"
Appanoose County,Iowa,12887,44.2,9993,2592,6271,6616,"(40.750570000000003, -92.866860000000003)"
Audubon County,Iowa,6119,47,4780,1419,2957,3162,"(41.683320000000002, -94.900260000000003)"
Benton County,Iowa,26076,40.9,19430,4015,13027,13049,"(42.066659999999999, -92.066850000000002)"
Black Hawk County,Iowa,131090,34.4,102594,18131,63708,67382,"(42.466650000000001, -92.316850000000002)"
Boone County,Iowa,26306,40.799999999999997,20027,4194,13202,13104,"(42.033320000000003, -93.93356)"
Bremer County,Iowa,24276,39.299999999999997,18763,4192,11869,12407,"(42.766649999999998, -92.316850000000002)"
Buchanan County,Iowa,20958,39,15282,3205,10401,10557,"(42.466650000000001, -91.850170000000006)"
Buena Vista County,Iowa,20260,37.1,15204,3055,10142,10118,"(42.733310000000003, -95.150270000000006)"
Butler County,Iowa,14867,43.8,11364,2944,7337,7530,"(42.733310000000003, -92.783529999999999)"
Calhoun County,Iowa,9670,47.8,7618,2292,4697,4973,"(42.383310000000002, -94.650260000000003)"
Carroll County,Iowa,20816,42.3,15640,3874,10141,10675,"(42.033320000000003, -94.883600000000001)"
Cass County,Iowa,13956,45.1,10768,2924,6819,7137,"(41.333320000000001, -94.933599999999998)"
Cedar County,Iowa,18499,42.4,13962,3093,9151,9348,"(41.766689999999997, -91.133489999999995)"
Cerro Gordo County,Iowa,44151,43.3,34660,7919,21542,22609,"(43.083300000000001, -93.266869999999997)"
Cherokee County,Iowa,12072,47,9517,2604,5954,6118,"(42.733319999999999, -95.616950000000003)"
Chickasaw County,Iowa,12439,43.7,9404,2376,6255,6184,"(43.06664, -92.316839999999999)"
Clarke County,Iowa,9286,40.200000000000003,6940,1549,4626,4660,"(41.033329999999999, -93.783550000000005)"
Clay County,Iowa,16667,42.5,12837,3066,8171,8496,"(43.083300000000001, -95.150270000000006)"
Clayton County,Iowa,18129,45,13925,3504,9079,9050,"(42.833320000000001, -91.366799999999998)"
Clinton County,Iowa,49116,41.4,37526,8267,24165,24951,"(41.883360000000003, -90.550139999999999)"
Crawford County,Iowa,17096,38.4,12580,2793,8685,8411,"(42.033320000000003, -95.383610000000004)"
Dallas County,Iowa,66135,34.299999999999997,46914,6476,32349,33786,"(41.683320000000002, -94.050229999999999)"
Davis County,Iowa,8753,38.6,6203,1493,4340,4413,"(40.750579999999999, -92.416849999999997)"
Decatur County,Iowa,8457,38.200000000000003,6539,1533,4238,4219,"(40.75056, -93.783559999999994)"
Delaware County,Iowa,17764,42.1,13281,2944,8875,8889,"(42.466659999999997, -91.366810000000001)"
Des Moines County,Iowa,40325,41.5,30982,7096,19600,20725,"(40.916699999999999, -91.183480000000003)"
Dickinson County,Iowa,16667,48.1,13440,3712,8260,8407,"(43.383299999999998, -95.150270000000006)"
Dubuque County,Iowa,93653,38.6,71401,14355,46132,47521,"(42.483330000000002, -90.866799999999998)"
Emmet County,Iowa,10302,41,7932,1939,5143,5159,"(43.374400000000001, -94.666929999999994)"
Fayette County,Iowa,20880,43.2,16189,4055,10432,10448,"(42.86665, -91.850160000000002)"
Floyd County,Iowa,16303,43.3,12412,3263,7989,8314,"(43.06664, -92.783529999999999)"
Franklin County,Iowa,10680,42.8,8133,2037,5380,5300,"(42.733310000000003, -93.266869999999997)"
Fremont County,Iowa,7441,45.1,5742,1456,3695,3746,"(40.75056, -95.600269999999995)"
Greene County,Iowa,9336,45.6,7180,1951,4613,4723,"(42.033320000000003, -94.40025)"
Grundy County,Iowa,12453,43,9488,2342,6156,6297,"(42.399979999999999, -92.800200000000004)"
Guthrie County,Iowa,10954,44.8,8333,2178,5443,5511,"(41.683320000000002, -94.500799999999998)"
Hamilton County,Iowa,15673,42.3,11904,2835,7792,7881,"(42.383310000000002, -93.716880000000003)"
Hancock County,Iowa,11341,44.8,8683,2166,5656,5685,"(43.083289999999998, -93.716880000000003)"
Hardin County,Iowa,17534,43.7,13486,3675,8717,8817,"(42.383319999999998, -93.25076)"
Harrison County,Iowa,14928,42.9,11333,2659,7348,7580,"(41.683320000000002, -95.783619999999999)"
Henry County,Iowa,20145,40.200000000000003,15476,3228,10310,9835,"(40.983359999999998, -91.550160000000005)"
Howard County,Iowa,9566,42.1,7154,1847,4746,4820,"(43.349969999999999, -92.316839999999999)"
Humboldt County,Iowa,9815,44.3,7557,2021,4847,4968,"(42.866639999999997, -94.200239999999994)"
Ida County,Iowa,7089,44.8,5391,1465,3539,3550,"(42.383319999999998, -95.516949999999994)"
Iowa County,Iowa,16355,42.4,12338,2811,8069,8286,"(41.683340000000001, -92.066850000000002)"
Jackson County,Iowa,19848,44,15243,3693,9846,10002,"(42.166679999999999, -90.583460000000002)"
Jasper County,Iowa,36842,41.6,28425,6089,18764,18078,"(41.683320000000002, -93.050200000000004)"
Jefferson County,Iowa,16843,43.5,13777,2501,8997,7846,"(41.033349999999999, -91.95017)"
Johnson County,Iowa,130882,29.3,104964,11211,65462,65420,"(41.666679999999999, -91.533500000000004)"
Jones County,Iowa,20638,42.7,16012,3556,10713,9925,"(42.116669999999999, -91.133480000000006)"
Keokuk County,Iowa,10511,43.8,8069,2021,5226,5285,"(41.33334, -92.183509999999998)"
Kossuth County,Iowa,15543,46.6,11988,3399,7708,7835,"(43.199959999999997, -94.216909999999999)"
Lee County,Iowa,35862,42.6,27901,6078,18131,17731,"(40.650039999999997, -91.483490000000003)"
Linn County,Iowa,211226,36.5,159379,27488,103950,107276,"(42.066659999999999, -91.600179999999995)"
Louisa County,Iowa,11387,39.799999999999997,8444,1704,5793,5594,"(41.233359999999998, -91.266819999999996)"
Lucas County,Iowa,8898,44.1,6723,1794,4432,4466,"(41.033329999999999, -93.300210000000007)"
Lyon County,Iowa,11581,38.700000000000003,8376,1948,5783,5798,"(43.383310000000002, -96.250860000000003)"
Madison County,Iowa,15679,39.799999999999997,11411,2321,7797,7882,"(41.333320000000001, -94.016900000000007)"
Mahaska County,Iowa,22381,38.9,16940,3598,11252,11129,"(41.33334, -92.650189999999995)"
Marion County,Iowa,33309,38.6,24947,5192,16541,16768,"(41.333329999999997, -93.100200000000001)"
Marshall County,Iowa,40648,39.6,30344,6677,20428,20220,"(42.033320000000003, -93.00076)"
Mills County,Iowa,15059,41.2,11240,2023,7572,7487,"(41.033329999999999, -95.616950000000003)"
Mitchell County,Iowa,10776,44,8112,2342,5309,5467,"(43.349969999999999, -92.783519999999996)"
Monona County,Iowa,9243,47.5,7195,2190,4516,4727,"(42.033320000000003, -95.96696)"
Monroe County,Iowa,7970,42.1,6045,1482,3976,3994,"(41.033340000000003, -92.866860000000003)"
Montgomery County,Iowa,10740,44.6,8229,2141,5209,5531,"(41.033329999999999, -95.166929999999994)"
Muscatine County,Iowa,42745,38.200000000000003,31581,5843,21227,21518,"(41.46669, -91.133489999999995)"
O'Brien County,Iowa,14398,43.6,11005,2937,7166,7232,"(43.083309999999997, -95.633619999999993)"
Osceola County,Iowa,6462,43.5,4972,1276,3243,3219,"(43.383299999999998, -95.633619999999993)"
Page County,Iowa,15932,43.7,12426,3175,8261,7671,"(40.750549999999997, -95.166929999999994)"
Palo Alto County,Iowa,9421,43.9,7353,2009,4678,4743,"(43.083300000000001, -94.666920000000005)"
Plymouth County,Iowa,24986,41.2,18502,4149,12373,12613,"(42.733319999999999, -96.233639999999994)"
Pocahontas County,Iowa,7310,47.6,5741,1617,3633,3677,"(42.733310000000003, -94.666920000000005)"
Polk County,Iowa,430640,34.700000000000003,320715,46545,211171,219469,"(41.683320000000002, -93.583550000000002)"
Pottawattamie County,Iowa,93158,38.5,70679,13333,45690,47468,"(41.333329999999997, -95.533609999999996)"
Poweshiek County,Iowa,18914,41,14962,3488,9257,9657,"(41.683329999999998, -92.533519999999996)"
Ringgold County,Iowa,5131,45.6,3888,1209,2492,2639,"(40.750549999999997, -94.250789999999995)"
Sac County,Iowa,10350,46.6,8025,2291,5064,5286,"(42.383319999999998, -95.11694)"
Scott County,Iowa,165224,37.700000000000003,124658,21605,80977,84247,"(41.633360000000003, -90.633470000000003)"
Shelby County,Iowa,12167,45.4,9301,2540,5942,6225,"(41.683320000000002, -95.333609999999993)"
Sioux County,Iowa,33704,32.700000000000003,24657,4808,16831,16873,"(42.733319999999999, -96.233639999999994)"
Story County,Iowa,89542,26.7,73589,8945,46412,43130,"(42.033320000000003, -93.466880000000003)"
Tama County,Iowa,17767,41.8,13227,3274,8731,9036,"(42.066659999999999, -92.533529999999999)"
Taylor County,Iowa,6317,44.6,4841,1327,3147,3170,"(40.750540000000001, -94.666910000000001)"
Union County,Iowa,12534,40.9,9598,2267,6106,6428,"(41.033320000000003, -94.250789999999995)"
Van Buren County,Iowa,7570,43.3,5748,1498,3806,3764,"(40.750579999999999, -91.966840000000005)"
Wapello County,Iowa,35625,39.799999999999997,27506,5856,17422,18203,"(41.033349999999999, -92.416849999999997)"
Warren County,Iowa,46225,38.299999999999997,34207,6159,22507,23718,"(41.333329999999997, -93.550219999999996)"
Washington County,Iowa,21704,41.6,16245,3758,10626,11078,"(41.333350000000003, -91.716830000000002)"
Wayne County,Iowa,6403,45.3,4903,1418,3118,3285,"(40.75056, -93.300210000000007)"
Webster County,Iowa,38013,40,29594,6337,19467,18546,"(42.433300000000003, -94.166899999999998)"
Winnebago County,Iowa,10866,43.5,8512,2093,5383,5483,"(43.383290000000002, -93.716890000000006)"
Winneshiek County,Iowa,21056,39.4,16759,3547,10450,10606,"(43.283299999999997, -91.850160000000002)"
Woodbury County,Iowa,102172,35.1,74958,13125,50394,51778,"(42.383319999999998, -96.033630000000002)"
Worth County,Iowa,7598,43.8,5841,1390,3786,3812,"(43.383290000000002, -93.266869999999997)"
Wright County,Iowa,13229,44.4,10143,2769,6575,6654,"(42.733310000000003, -93.716880000000003)"
Allen County,Kansas,13371,40.799999999999997,10223,2445,6525,6846,"(37.883369999999999, -95.283590000000004)"
Anderson County,Kansas,8102,42.1,6045,1633,4013,4089,"(38.200020000000002, -95.283590000000004)"
Atchison County,Kansas,16924,36.299999999999997,12831,2601,8236,8688,"(39.533329999999999, -95.300250000000005)"
Barber County,Kansas,4861,45.8,3769,991,2451,2410,"(37.233359999999998, -98.683700000000002)"
Barton County,Kansas,27674,39.700000000000003,20890,4688,13589,14085,"(38.466679999999997, -98.767030000000005)"
Bourbon County,Kansas,15173,38.200000000000003,11287,2628,7430,7743,"(37.85004, -94.850239999999999)"
Brown County,Kansas,9984,41.9,7450,1829,4867,5117,"(39.799999999999997, -95.583590000000001)"
Butler County,Kansas,65880,37.200000000000003,48129,8327,33178,32702,"(37.783349999999999, -96.833640000000003)"
Chase County,Kansas,2790,45.6,2175,591,1422,1368,"(38.300020000000004, -96.583619999999996)"
Chautauqua County,Kansas,3669,48.2,2911,896,1861,1808,"(37.15005, -96.233599999999996)"
Cherokee County,Kansas,21603,40.5,16214,3448,10740,10863,"(37.166730000000001, -94.850239999999999)"
Cheyenne County,Kansas,2726,50,2145,717,1375,1351,"(39.799990000000001, -101.80045)"
Clark County,Kansas,2215,44.9,1656,487,1074,1141,"(37.233359999999998, -99.833740000000006)"
Clay County,Kansas,8535,43.3,6514,1744,4225,4310,"(39.35, -97.166970000000006)"
Cloud County,Kansas,9533,42.2,7396,1948,4657,4876,"(39.483330000000002, -97.650319999999994)"
Coffey County,Kansas,8601,43,6514,1483,4252,4349,"(38.233350000000002, -95.733599999999996)"
Comanche County,Kansas,1891,47.4,1456,455,911,980,"(37.18336, -99.267060000000001)"
Cowley County,Kansas,36311,38.5,27441,5726,18111,18200,"(37.233359999999998, -96.833640000000003)"
Crawford County,Kansas,39134,32.6,30409,5463,19421,19713,"(37.516719999999999, -94.850239999999999)"
Decatur County,Kansas,2961,51.4,2406,808,1483,1478,"(39.80001, -100.46709)"
Dickinson County,Kansas,19754,41.4,14859,3566,9732,10022,"(38.883330000000001, -97.166960000000003)"
Doniphan County,Kansas,7945,39.6,6170,1286,4006,3939,"(39.799999999999997, -95.116919999999993)"
Douglas County,Kansas,110826,28.4,89695,9867,55573,55253,"(38.866669999999999, -95.233580000000003)"
Edwards County,Kansas,3037,44.8,2316,581,1511,1526,"(37.88335, -99.267060000000001)"
Elk County,Kansas,2882,48.8,2267,700,1428,1454,"(37.450040000000001, -96.233599999999996)"
Ellis County,Kansas,28452,32.200000000000003,22471,3829,14151,14301,"(38.916679999999999, -99.317049999999995)"
Ellsworth County,Kansas,6497,44.3,5280,1228,3649,2848,"(38.700009999999999, -98.200329999999994)"
Finney County,Kansas,36776,30.2,25000,3089,18452,18324,"(38.016689999999997, -100.6671)"
Ford County,Kansas,33848,30.4,23378,3377,17470,16378,"(37.700020000000002, -99.900409999999994)"
Franklin County,Kansas,25992,38.1,19242,3673,12873,13119,"(38.583350000000003, -95.283590000000004)"
Geary County,Kansas,34362,27.7,23745,2628,16994,17368,"(38.997219999999999, -96.66695)"
Gove County,Kansas,2695,48.3,2093,647,1348,1347,"(38.916679999999999, -100.48375)"
Graham County,Kansas,2597,49.4,2100,666,1270,1327,"(39.350009999999997, -99.88373)"
Grant County,Kansas,7829,32.799999999999997,5374,820,4000,3829,"(37.583350000000003, -101.33378)"
Gray County,Kansas,6006,34.700000000000003,4183,761,2950,3056,"(37.733359999999998, -100.43376000000001)"
Greeley County,Kansas,1247,46.6,981,261,595,652,"(38.466679999999997, -101.83378999999999)"
Greenwood County,Kansas,6689,46.7,5212,1485,3301,3388,"(37.866689999999998, -96.266949999999994)"
Hamilton County,Kansas,2690,33.5,1927,366,1364,1326,"(38.016680000000001, -101.66712)"
Harper County,Kansas,6034,44.1,4606,1307,2985,3049,"(37.200020000000002, -98.083669999999998)"
Harvey County,Kansas,34684,38.9,25831,5943,16937,17747,"(38.05001, -97.43365)"
Haskell County,Kansas,4256,34.299999999999997,2930,456,2130,2126,"(37.566690000000001, -100.86711)"
Hodgeman County,Kansas,1916,46.1,1456,396,958,958,"(38.083350000000003, -99.900409999999994)"
Jackson County,Kansas,13462,40.700000000000003,9888,2073,6744,6718,"(39.4, -95.833600000000004)"
Jefferson County,Kansas,19126,42.6,14401,2952,9698,9428,"(39.216670000000001, -95.40025)"
Jewell County,Kansas,3077,52.5,2500,863,1574,1503,"(39.80001, -98.23366)"
Johnson County,Kansas,544179,36.4,400823,59322,265733,278446,"(38.866669999999999, -94.866910000000004)"
Kearny County,Kansas,3977,35.5,2790,535,2021,1956,"(37.983350000000002, -101.31711)"
Kingman County,Kansas,7858,44.5,5958,1570,3898,3960,"(37.566679999999998, -98.133679999999998)"
Kiowa County,Kansas,2553,41.9,2003,482,1257,1296,"(37.566690000000001, -99.283720000000002)"
Labette County,Kansas,21607,40.5,16345,3587,10697,10910,"(37.200069999999997, -95.283580000000001)"
Lane County,Kansas,1750,46.1,1356,369,856,894,"(38.466679999999997, -100.46708)"
Leavenworth County,Kansas,76227,37.4,57080,8426,40466,35761,"(39.233330000000002, -95.033580000000001)"
Lincoln County,Kansas,3241,46.4,2461,659,1618,1623,"(39.05001, -98.200329999999994)"
Linn County,Kansas,9656,44.8,7416,1867,4842,4814,"(38.21669, -94.850239999999999)"
Logan County,Kansas,2756,44.9,2127,572,1363,1393,"(38.900010000000002, -101.13377)"
Lyon County,Kansas,33690,32.5,25750,4213,16489,17201,"(38.450009999999999, -96.150270000000006)"
McPherson County,Kansas,29180,41.4,22322,5339,14334,14846,"(38.400010000000002, -97.666989999999998)"
Marion County,Kansas,12660,44.6,9794,2641,6372,6288,"(38.400010000000002, -97.150300000000001)"
Marshall County,Kansas,10117,45.2,7781,2134,5003,5114,"(39.799999999999997, -96.550290000000004)"
Meade County,Kansas,4575,38.799999999999997,3247,785,2324,2251,"(37.233359999999998, -100.36709)"
Miami County,Kansas,32787,39.5,23944,4287,16201,16586,"(38.583350000000003, -94.850239999999999)"
Mitchell County,Kansas,6373,45.6,5006,1341,3218,3155,"(39.400010000000002, -98.200329999999994)"
Montgomery County,Kansas,35471,39.9,27072,6156,17404,18067,"(37.200069999999997, -95.733590000000007)"
Morris County,Kansas,5923,47.2,4651,1322,2955,2968,"(38.700009999999999, -96.633619999999993)"
Morton County,Kansas,3233,38.9,2360,548,1572,1661,"(37.200020000000002, -101.80043999999999)"
Nemaha County,Kansas,10178,42.5,7511,2049,5145,5033,"(39.799999999999997, -96.016940000000005)"
Neosho County,Kansas,16512,40.200000000000003,12430,2866,8151,8361,"(37.566719999999997, -95.283590000000004)"
Ness County,Kansas,3107,48.2,2411,763,1559,1548,"(38.466679999999997, -99.917069999999995)"
Norton County,Kansas,5671,43.5,4538,1057,3170,2501,"(39.80001, -99.917069999999995)"
Osage County,Kansas,16295,42.8,12248,2773,8098,8197,"(38.650010000000002, -95.733599999999996)"
Osborne County,Kansas,3858,48.2,3044,974,1918,1940,"(39.350009999999997, -98.783690000000007)"
Ottawa County,Kansas,6091,42.7,4542,1066,3144,2947,"(39.133330000000001, -97.666979999999995)"
Pawnee County,Kansas,6973,43.2,5445,1215,3870,3103,"(38.150010000000002, -99.200379999999996)"
Phillips County,Kansas,5642,45.3,4275,1140,2794,2848,"(39.80001, -99.350380000000001)"
Pottawatomie County,Kansas,21604,34.799999999999997,15193,2660,10716,10888,"(39.333329999999997, -96.300280000000001)"
Pratt County,Kansas,9656,40.9,7451,1822,4761,4895,"(37.650019999999998, -98.733699999999999)"
Rawlins County,Kansas,2519,51.3,2044,672,1255,1264,"(39.799999999999997, -101.10044000000001)"
Reno County,Kansas,64511,39.9,49275,10994,32315,32196,"(37.950009999999999, -98.083669999999998)"
Republic County,Kansas,4980,50.6,4018,1347,2447,2533,"(39.80001, -97.633650000000003)"
Rice County,Kansas,10083,39.299999999999997,7674,1801,5066,5017,"(38.350009999999997, -98.200339999999997)"
Riley County,Kansas,71115,24.3,57947,5208,37040,34075,"(39.333329999999997, -96.700289999999995)"
Rooks County,Kansas,5181,44.1,3957,1024,2533,2648,"(39.350009999999997, -99.317040000000006)"
Rush County,Kansas,3307,48.7,2666,796,1630,1677,"(38.516680000000001, -99.300380000000004)"
Russell County,Kansas,6970,46.5,5487,1588,3443,3527,"(38.916679999999999, -98.767020000000002)"
Saline County,Kansas,55606,37.799999999999997,41670,8002,27675,27931,"(38.783340000000003, -97.666979999999995)"
Scott County,Kansas,4936,41.4,3700,900,2487,2449,"(38.46669, -100.90043)"
Sedgwick County,Kansas,498365,34.200000000000003,362989,56969,246042,252323,"(37.716679999999997, -97.450320000000005)"
Seward County,Kansas,22952,28.9,15617,1948,11830,11122,"(37.200020000000002, -100.83377)"
Shawnee County,Kansas,177934,38.1,133763,25612,85996,91938,"(39.049999999999997, -95.766930000000002)"
Sheridan County,Kansas,2556,46.9,1953,563,1300,1256,"(39.35, -100.43375)"
Sherman County,Kansas,6010,42.1,4660,1145,3005,3005,"(39.35, -101.71711999999999)"
Smith County,Kansas,3853,49.6,3079,1018,1889,1964,"(39.833350000000003, -98.750630000000001)"
Stafford County,Kansas,4437,45.6,3400,930,2211,2226,"(38.066679999999998, -98.717029999999994)"
Stanton County,Kansas,2235,35.6,1585,348,1141,1094,"(37.566679999999998, -101.78377999999999)"
Stevens County,Kansas,5724,34.4,3973,752,2840,2884,"(37.200020000000002, -101.30043999999999)"
Sumner County,Kansas,24132,40.5,17818,3786,12039,12093,"(37.233359999999998, -97.48366)"
Thomas County,Kansas,7900,36.6,6056,1216,3884,4016,"(39.35, -101.05043000000001)"
Trego County,Kansas,3001,49.3,2402,703,1481,1520,"(38.916679999999999, -99.88373)"
Wabaunsee County,Kansas,7053,42.6,5261,1111,3593,3460,"(39.129170000000002, -95.996099999999998)"
Wallace County,Kansas,1485,45.4,1111,303,742,743,"(38.916679999999999, -101.76712000000001)"
Washington County,Kansas,5799,46.4,4471,1343,2939,2860,"(39.799999999999997, -97.100309999999993)"
Wichita County,Kansas,2234,40.299999999999997,1626,401,1143,1091,"(38.46669, -101.35044000000001)"
Wilson County,Kansas,9409,43.1,7116,1813,4622,4787,"(37.566719999999997, -95.733590000000007)"
Woodson County,Kansas,3309,48.2,2651,750,1655,1654,"(37.883369999999999, -95.733599999999996)"
Wyandotte County,Kansas,157505,32.799999999999997,113070,16805,77702,79803,"(39.116669999999999, -94.716899999999995)"
Adair County,Kentucky,18656,39,14450,2859,9208,9448,"(37.116729999999997, -85.299959999999999)"
Allen County,Kentucky,19956,39.200000000000003,15069,2931,9805,10151,"(36.750599999999999, -86.19999)"
Anderson County,Kentucky,21421,38.4,15975,2579,10468,10953,"(38.000630000000001, -84.966620000000006)"
Ballard County,Kentucky,8249,42.4,6421,1450,4096,4153,"(37.050049999999999, -89.000619999999998)"
Barren County,Kentucky,42173,39.700000000000003,31957,6500,20464,21709,"(36.950049999999997, -85.949979999999996)"
Bath County,Kentucky,11591,39.9,8725,1706,5751,5840,"(38.150080000000003, -83.750470000000007)"
Bell County,Kentucky,28691,41,22462,4508,13937,14754,"(36.750639999999997, -83.683250000000001)"
Boone County,Kentucky,118811,35.700000000000003,85232,11313,58782,60029,"(38.866729999999997, -84.633279999999999)"
Bourbon County,Kentucky,19985,40.700000000000003,15172,3049,9742,10243,"(38.20008, -84.2166)"
Boyd County,Kentucky,49542,41.8,38949,8242,24622,24920,"(38.366750000000003, -82.683220000000006)"
Boyle County,Kentucky,28432,40.6,22274,4608,13833,14599,"(37.633409999999998, -84.866619999999998)"
Bracken County,Kentucky,8488,39.200000000000003,6336,1159,4228,4260,"(38.683410000000002, -84.083259999999996)"
Breathitt County,Kentucky,13878,40,10658,1866,6934,6944,"(37.53342, -83.316569999999999)"
Breckinridge County,Kentucky,20059,41.6,15209,3131,10000,10059,"(37.7834, -86.266639999999995)"
Bullitt County,Kentucky,74319,38.200000000000003,55536,8287,36782,37537,"(37.966729999999998, -85.716629999999995)"
Butler County,Kentucky,12690,40.1,9764,2005,6358,6332,"(37.233379999999997, -86.683319999999995)"
Caldwell County,Kentucky,12984,42.6,10099,2314,6258,6726,"(37.15005, -87.850009999999997)"
Calloway County,Kentucky,37191,34,30479,5620,17925,19266,"(36.633389999999999, -88.2667)"
Campbell County,Kentucky,90336,37,69736,11557,44269,46067,"(38.950060000000001, -84.383269999999996)"
Carlisle County,Kentucky,5104,42.9,3950,965,2492,2612,"(36.850059999999999, -88.950059999999993)"
Carroll County,Kentucky,10811,37.6,8093,1395,5506,5305,"(38.650060000000003, -85.116619999999998)"
Carter County,Kentucky,27720,39.299999999999997,21216,4119,13803,13917,"(38.316749999999999, -83.033230000000003)"
Casey County,Kentucky,15955,40.6,12190,2573,7787,8168,"(37.333410000000001, -84.949950000000001)"
Christian County,Kentucky,73955,28.9,52880,7593,37482,36473,"(36.883380000000002, -87.483339999999998)"
Clark County,Kentucky,35613,39.799999999999997,27244,5046,17394,18219,"(37.983409999999999, -84.266599999999997)"
Clay County,Kentucky,21730,37.700000000000003,16958,2622,11611,10119,"(37.166759999999996, -83.750470000000007)"
Clinton County,Kentucky,10272,41.6,7821,1703,5138,5134,"(36.750619999999998, -85.149959999999993)"
Crittenden County,Kentucky,9315,42.6,7205,1687,4646,4669,"(37.333379999999998, -88.083359999999999)"
Cumberland County,Kentucky,6856,43.8,5332,1309,3366,3490,"(36.800060000000002, -85.399959999999993)"
Daviess County,Kentucky,96656,38.799999999999997,73051,14118,46912,49744,"(37.700049999999997, -87.116659999999996)"
Edmonson County,Kentucky,12161,41.3,9504,2023,6071,6090,"(37.200049999999997, -86.250529999999998)"
Elliott County,Kentucky,7852,39.9,6252,1134,4401,3451,"(38.116750000000003, -83.116560000000007)"
Estill County,Kentucky,14672,41.3,11333,2247,7233,7439,"(37.70008, -83.949920000000006)"
Fayette County,Kentucky,295803,33.700000000000003,233170,31138,145591,150212,"(38.050080000000001, -84.449939999999998)"
Fleming County,Kentucky,14348,40.1,10842,2118,7041,7307,"(38.350079999999998, -83.683250000000001)"
Floyd County,Kentucky,39451,39.9,30577,5351,19295,20156,"(37.5501, -82.750439999999998)"
Franklin County,Kentucky,49285,39.799999999999997,38620,6882,23876,25409,"(38.233400000000003, -84.866619999999998)"
Fulton County,Kentucky,6813,42.8,5445,1223,3381,3432,"(36.550060000000002, -89.133399999999995)"
Gallatin County,Kentucky,8589,37.4,6286,979,4308,4281,"(38.750619999999998, -84.849950000000007)"
Garrard County,Kentucky,16912,41.2,12998,2463,8343,8569,"(37.616750000000003, -84.549940000000007)"
Grant County,Kentucky,24662,35.299999999999997,17739,2648,12301,12361,"(38.650069999999999, -84.649940000000001)"
Graves County,Kentucky,37121,39.799999999999997,28069,6145,18207,18914,"(36.73339, -88.650049999999993)"
Grayson County,Kentucky,25746,39.700000000000003,19602,3884,13052,12694,"(37.466720000000002, -86.349980000000002)"
Green County,Kentucky,11258,42.6,8709,1946,5548,5710,"(37.266730000000003, -85.533299999999997)"
Greenup County,Kentucky,36910,42,28585,6288,17860,19050,"(38.516750000000002, -82.949889999999996)"
Hancock County,Kentucky,8565,39.5,6340,1196,4328,4237,"(37.850050000000003, -86.766660000000002)"
Hardin County,Kentucky,105543,35,78127,11608,52663,52880,"(37.700060000000001, -85.966629999999995)"
Harlan County,Kentucky,29278,40.5,22593,4179,14273,15005,"(36.850090000000002, -83.183229999999995)"
Harrison County,Kentucky,18846,40.700000000000003,14265,2812,9216,9630,"(38.450069999999997, -84.349940000000004)"
Hart County,Kentucky,18199,40.1,13654,2713,9001,9198,"(37.300049999999999, -85.883300000000006)"
Henderson County,Kentucky,46250,39.799999999999997,35380,6551,22317,23933,"(37.783380000000001, -87.566680000000005)"
Henry County,Kentucky,15416,40.6,11593,2190,7596,7820,"(38.450069999999997, -85.149950000000004)"
Hickman County,Kentucky,4902,44.8,3848,1019,2345,2557,"(36.666730000000001, -88.983400000000003)"
Hopkins County,Kentucky,46920,40.4,36029,7244,22805,24115,"(37.333379999999998, -87.55)"
Jackson County,Kentucky,13494,39.5,10312,1862,6711,6783,"(37.41675, -84.000479999999996)"
Jefferson County,Kentucky,741096,37.9,569289,99095,357699,383397,"(38.183399999999999, -85.649959999999993)"
Jessamine County,Kentucky,48586,35.799999999999997,36037,5494,23668,24918,"(37.866750000000003, -84.566609999999997)"
Johnson County,Kentucky,23356,40.4,18107,3301,11484,11872,"(37.850090000000002, -82.849879999999999)"
Kenton County,Kentucky,159720,36,119774,17853,78915,80805,"(38.950060000000001, -84.533280000000005)"
Knott County,Kentucky,16346,40.5,12810,2183,8148,8198,"(37.350099999999998, -82.949889999999996)"
Knox County,Kentucky,31883,38.5,24020,4650,15516,16367,"(36.883420000000001, -83.849919999999997)"
Larue County,Kentucky,14193,40.200000000000003,10818,2214,7038,7155,"(37.550060000000002, -85.699960000000004)"
Laurel County,Kentucky,58849,38.4,44538,7577,28849,30000,"(37.133420000000001, -84.133269999999996)"
Lawrence County,Kentucky,15860,40.1,12179,2245,7836,8024,"(38.066760000000002, -82.766549999999995)"
Lee County,Kentucky,7887,40.9,6349,1043,4325,3562,"(37.600090000000002, -83.699910000000003)"
Leslie County,Kentucky,11310,41.1,8892,1603,5600,5710,"(37.100090000000002, -83.366569999999996)"
Letcher County,Kentucky,24519,40.9,19089,3476,12081,12438,"(37.133429999999997, -82.866550000000004)"
Lewis County,Kentucky,13870,40.299999999999997,10562,2043,6920,6950,"(38.533410000000003, -83.483239999999995)"
Lincoln County,Kentucky,24742,39.5,18642,3680,12218,12524,"(37.45008, -84.666610000000006)"
Livingston County,Kentucky,9519,44.9,7566,1725,4666,4853,"(37.216720000000002, -88.333370000000002)"
Logan County,Kentucky,26835,40.200000000000003,20247,4202,13130,13705,"(36.866709999999998, -86.866659999999996)"
Lyon County,Kentucky,8314,47.9,7031,1742,4579,3735,"(37.033389999999997, -88.066689999999994)"
McCracken County,Kentucky,65565,41.8,50859,11001,31440,34125,"(37.050060000000002, -88.700050000000005)"
McCreary County,Kentucky,18306,37.9,14189,2249,9948,8358,"(36.733409999999999, -84.466610000000003)"
McLean County,Kentucky,9531,41.5,7306,1611,4676,4855,"(37.533380000000001, -87.250550000000004)"
Madison County,Kentucky,82916,33.700000000000003,65066,9312,40264,42652,"(37.733409999999999, -84.299930000000003)"
Magoffin County,Kentucky,13333,39.1,10139,1721,6676,6657,"(37.700090000000003, -83.08323)"
Marion County,Kentucky,19820,37.799999999999997,14932,2580,10242,9578,"(37.550060000000002, -85.266630000000006)"
Marshall County,Kentucky,31448,44.3,24908,6066,15466,15982,"(36.866720000000001, -88.350040000000007)"
Martin County,Kentucky,12929,37.299999999999997,10171,1452,7150,5779,"(37.816760000000002, -82.516540000000006)"
Mason County,Kentucky,17490,40.299999999999997,13225,2645,8434,9056,"(38.583410000000001, -83.79992)"
Meade County,Kentucky,28602,35,20797,2975,14341,14261,"(37.966740000000001, -86.233310000000003)"
Menifee County,Kentucky,6306,40.6,4842,1005,3147,3159,"(37.933419999999998, -83.599909999999994)"
Mercer County,Kentucky,21331,41.7,16293,3395,10407,10924,"(37.833410000000001, -84.866619999999998)"
Metcalfe County,Kentucky,10099,40.700000000000003,7680,1644,5008,5091,"(36.98339, -85.616640000000004)"
Monroe County,Kentucky,10963,42.1,8417,1880,5425,5538,"(36.716720000000002, -85.733310000000003)"
Montgomery County,Kentucky,26499,38,19999,3393,12941,13558,"(38.050080000000001, -83.916589999999999)"
Morgan County,Kentucky,13923,38.6,11083,1810,7889,6034,"(37.91675, -83.266570000000002)"
Muhlenberg County,Kentucky,31499,40.9,24678,5110,15909,15590,"(37.216709999999999, -87.15)"
Nelson County,Kentucky,43437,37.700000000000003,32152,5097,21368,22069,"(37.800060000000002, -85.466629999999995)"
Nicholas County,Kentucky,7135,40.5,5411,1110,3546,3589,"(38.316740000000003, -84.000479999999996)"
Ohio County,Kentucky,23842,39.1,17908,3682,11912,11930,"(37.466720000000002, -86.866659999999996)"
Oldham County,Kentucky,60316,39,43520,5573,31737,28579,"(38.416730000000001, -85.449960000000004)"
Owen County,Kentucky,10841,40.1,8178,1570,5385,5456,"(38.516730000000003, -84.833280000000002)"
Owsley County,Kentucky,4755,42.2,3697,797,2356,2399,"(37.433419999999998, -83.666579999999996)"
Pendleton County,Kentucky,14877,39.5,11197,1827,7446,7431,"(38.700069999999997, -84.366600000000005)"
Perry County,Kentucky,28712,40.200000000000003,22468,3845,14206,14506,"(37.25065, -83.1999)"
Pike County,Kentucky,65024,40.299999999999997,50762,8922,31867,33157,"(37.466769999999997, -82.349869999999996)"
Powell County,Kentucky,12613,38.700000000000003,9508,1642,6270,6343,"(37.833419999999997, -83.816580000000002)"
Pulaski County,Kentucky,63063,41.1,48705,10241,30781,32282,"(37.11674, -84.599940000000004)"
Robertson County,Kentucky,2282,43.9,1792,427,1147,1135,"(38.533410000000003, -84.049930000000003)"
Rockcastle County,Kentucky,17056,40.6,13099,2529,8378,8678,"(37.366750000000003, -84.316599999999994)"
Rowan County,Kentucky,23333,31.7,18771,2860,11342,11991,"(38.183410000000002, -83.433239999999998)"
Russell County,Kentucky,17565,42.2,13642,3050,8595,8970,"(36.983400000000003, -85.033289999999994)"
Scott County,Kentucky,47173,35,34505,4367,23254,23919,"(38.300069999999998, -84.566609999999997)"
Shelby County,Kentucky,42074,38.299999999999997,31631,5060,20243,21831,"(38.200069999999997, -85.18329)"
Simpson County,Kentucky,17327,39.299999999999997,13059,2471,8472,8855,"(36.750599999999999, -86.583330000000004)"
Spencer County,Kentucky,17061,38.9,12675,1748,8659,8402,"(38.0334, -85.349950000000007)"
Taylor County,Kentucky,24512,39.4,19047,3923,11850,12662,"(37.350059999999999, -85.349959999999996)"
Todd County,Kentucky,12460,37.1,9067,1772,6152,6308,"(36.766710000000003, -87.133330000000001)"
Trigg County,Kentucky,14339,44.2,11111,2727,7039,7300,"(36.800049999999999, -87.866690000000006)"
Trimble County,Kentucky,8809,39.5,6599,1140,4483,4326,"(38.616729999999997, -85.333290000000005)"
Union County,Kentucky,15007,36.299999999999997,11560,2057,7670,7337,"(37.65005, -87.950029999999998)"
Warren County,Kentucky,113792,32.700000000000003,87880,12440,55696,58096,"(36.983379999999997, -86.399990000000003)"
Washington County,Kentucky,11717,40.700000000000003,9003,1862,5736,5981,"(37.766730000000003, -85.18329)"
Wayne County,Kentucky,20813,41.1,16117,3326,10295,10518,"(36.800069999999998, -84.816609999999997)"
Webster County,Kentucky,13621,40.1,10432,2060,6765,6856,"(37.516710000000003, -87.683340000000001)"
Whitley County,Kentucky,35637,38.1,27128,5084,17328,18309,"(36.766750000000002, -84.149929999999998)"
Wolfe County,Kentucky,7355,40.9,5587,1145,3608,3747,"(37.733420000000002, -83.483239999999995)"
Woodford County,Kentucky,24939,41,18936,3241,11969,12970,"(38.033410000000003, -84.733279999999993)"
Acadia Parish,Louisiana,61773,35.700000000000003,44910,7886,30161,31612,"(30.266870000000001, -92.400130000000004)"
Allen Parish,Louisiana,25764,37.4,19870,3328,14490,11274,"(30.650200000000002, -92.800150000000002)"
Ascension Parish,Louisiana,107215,34.299999999999997,76460,9494,52947,54268,"(30.21686, -90.900099999999995)"
Assumption Parish,Louisiana,23421,38.9,17665,3145,11456,11965,"(29.87576, -91.083430000000007)"
Avoyelles Parish,Louisiana,42073,38.1,31790,6075,21097,20976,"(31.066849999999999, -91.966790000000003)"
Beauregard Parish,Louisiana,35654,36.6,26359,4622,18170,17484,"(30.650200000000002, -93.333500000000001)"
Bienville Parish,Louisiana,14353,41.8,11012,2651,6921,7432,"(32.366819999999997, -93.050160000000005)"
Bossier Parish,Louisiana,116979,34.700000000000003,86945,14026,57511,59468,"(32.633479999999999, -93.600179999999995)"
Caddo Parish,Louisiana,254969,36.4,192315,34643,121191,133778,"(32.633479999999999, -93.900180000000006)"
Calcasieu Parish,Louisiana,192768,35.9,143756,24326,94038,98730,"(30.233540000000001, -93.350160000000002)"
Caldwell Parish,Louisiana,10132,39.6,7758,1504,5188,4944,"(32.100160000000002, -92.083470000000005)"
Cameron Parish,Louisiana,6839,39.9,5183,881,3395,3444,"(29.866879999999998, -93.216819999999998)"
Catahoula Parish,Louisiana,10407,38.799999999999997,8057,1503,5505,4902,"(31.666840000000001, -91.866799999999998)"
Claiborne Parish,Louisiana,17195,40.700000000000003,13815,2754,9611,7584,"(32.800150000000002, -93.016829999999999)"
Concordia Parish,Louisiana,20822,37.700000000000003,15589,3026,10474,10348,"(31.466840000000001, -91.650120000000001)"
De Soto Parish,Louisiana,26656,39.700000000000003,20006,3848,12862,13794,"(32.066830000000003, -93.766850000000005)"
East Baton Rouge Parish,Louisiana,440171,32.6,336506,48030,211488,228683,"(30.516860000000001, -91.100110000000001)"
East Carroll Parish,Louisiana,7759,34.299999999999997,5766,971,4154,3605,"(32.766800000000003, -91.250389999999996)"
East Feliciana Parish,Louisiana,20267,41.1,16075,2632,10898,9369,"(30.850180000000002, -91.0501)"
Evangeline Parish,Louisiana,33984,35.9,24817,4490,17115,16869,"(30.733529999999998, -92.383459999999999)"
Franklin Parish,Louisiana,20767,38.799999999999997,15450,3388,10072,10695,"(32.150149999999996, -91.683459999999997)"
Grant Parish,Louisiana,22309,36.799999999999997,17158,2690,12491,9818,"(31.766839999999998, -92.566810000000004)"
Iberia Parish,Louisiana,73240,35.6,53398,8914,35756,37484,"(29.950199999999999, -91.75067)"
Iberville Parish,Louisiana,33387,37.9,25885,4004,17020,16367,"(30.266860000000001, -91.400109999999998)"
Jackson Parish,Louisiana,16274,39.6,12570,2717,8273,8001,"(32.333489999999998, -92.550150000000002)"
Jefferson Parish,Louisiana,432552,38.4,335155,58988,210008,222544,"(29.733540000000001, -90.100070000000002)"
Jefferson Davis Parish,Louisiana,31594,37.700000000000003,23196,4585,15467,16127,"(30.2516, -92.833479999999994)"
Lafayette Parish,Louisiana,221578,33.200000000000003,167315,22787,108156,113422,"(30.233529999999998, -92.066789999999997)"
Lafourche Parish,Louisiana,96318,36.5,72652,12031,47324,48994,"(29.566880000000001, -90.383409999999998)"
La Salle Parish,Louisiana,14890,37.9,11366,2203,7665,7225,"(31.666840000000001, -92.166799999999995)"
Lincoln Parish,Louisiana,46735,27.8,37130,5286,22820,23915,"(32.616810000000001, -92.650149999999996)"
Livingston Parish,Louisiana,128026,34.4,92696,12671,63372,64654,"(30.450189999999999, -90.766760000000005)"
Madison Parish,Louisiana,12093,34.6,9071,1434,5986,6107,"(32.366810000000001, -91.251499999999993)"
Morehouse Parish,Louisiana,27979,39.1,21061,4310,13397,14582,"(32.800130000000003, -91.800129999999996)"
Natchitoches Parish,Louisiana,39566,33.299999999999997,29966,5329,18861,20705,"(31.766829999999999, -93.133499999999998)"
Orleans Parish,Louisiana,343829,34.6,270614,37639,166248,177581,"(30.033529999999999, -89.950069999999997)"
Ouachita Parish,Louisiana,153720,34.1,113347,18920,73530,80190,"(32.48348, -92.150139999999993)"
Plaquemines Parish,Louisiana,23042,36.299999999999997,16713,2577,11558,11484,"(29.450220000000002, -89.700059999999993)"
Pointe Coupee Parish,Louisiana,22802,41.4,17327,3534,11061,11741,"(30.733519999999999, -91.600120000000004)"
Rapides Parish,Louisiana,131613,36.9,97599,18012,63481,68132,"(31.16685, -92.483469999999997)"
Red River Parish,Louisiana,9091,38.799999999999997,6778,1386,4350,4741,"(32.083489999999998, -93.350170000000006)"
Richland Parish,Louisiana,20725,37.6,15440,2984,9984,10741,"(32.416809999999998, -91.750680000000003)"
Sabine Parish,Louisiana,24233,40.700000000000003,18311,4179,12009,12224,"(31.566839999999999, -93.550179999999997)"
St. Bernard Parish,Louisiana,35897,32.9,26720,3288,18162,17735,"(30.433530000000001, -89.966740000000001)"
St. Charles Parish,Louisiana,52780,36.5,38572,5235,26085,26695,"(30.433530000000001, -89.966740000000001)"
St. Helena Parish,Louisiana,11203,39.5,8440,1580,5521,5682,"(30.433530000000001, -89.966740000000001)"
St. James Parish,Louisiana,22102,37.9,16401,2841,10812,11290,"(30.433530000000001, -89.966740000000001)"
St. John the Baptist Parish,Louisiana,45924,35.5,33568,4736,22341,23583,"(30.433530000000001, -89.966740000000001)"
St. Landry Parish,Louisiana,83384,36.799999999999997,60704,11452,39876,43508,"(30.433530000000001, -89.966740000000001)"
St. Martin Parish,Louisiana,52160,36.299999999999997,38389,6086,25697,26463,"(30.433530000000001, -89.966740000000001)"
St. Mary Parish,Louisiana,54650,37.5,40746,7052,26992,27658,"(30.433530000000001, -89.966740000000001)"
St. Tammany Parish,Louisiana,233740,39.299999999999997,173604,29628,113973,119767,"(30.433530000000001, -89.966740000000001)"
Tangipahoa Parish,Louisiana,121097,33.6,90677,13803,58800,62297,"(30.66685, -90.400090000000006)"
Tensas Parish,Louisiana,5252,42.5,3923,908,2493,2759,"(31.98349, -91.333449999999999)"
Terrebonne Parish,Louisiana,111860,35,82737,12566,55568,56292,"(29.376609999999999, -90.850089999999994)"
Union Parish,Louisiana,22721,41,17493,3750,11214,11507,"(32.800139999999999, -92.400139999999993)"
Vermilion Parish,Louisiana,57999,36.4,42522,7508,28214,29785,"(29.816880000000001, -92.300129999999996)"
Vernon Parish,Louisiana,52334,29.6,37822,4929,26784,25550,"(31.116849999999999, -93.183499999999995)"
Washington Parish,Louisiana,47168,38.700000000000003,35305,6836,23360,23808,"(30.866849999999999, -90.033420000000007)"
Webster Parish,Louisiana,41207,40.299999999999997,31497,6894,20041,21166,"(32.716810000000002, -93.350170000000006)"
West Baton Rouge Parish,Louisiana,23788,35.799999999999997,17861,2617,11698,12090,"(30.46686, -91.333439999999996)"
West Carroll Parish,Louisiana,11604,39.4,8746,1954,5818,5786,"(32.800130000000003, -91.450119999999998)"
West Feliciana Parish,Louisiana,15625,41.9,12907,1590,10251,5374,"(30.850180000000002, -91.366780000000006)"
Winn Parish,Louisiana,15313,39.5,11871,2201,8031,7282,"(31.933499999999999, -92.600149999999999)"
Androscoggin County,Maine,107702,39.799999999999997,83394,15184,52716,54986,"(44.166739999999997, -70.166160000000005)"
Aroostook County,Maine,71870,45.3,57486,13651,35387,36483,"(46.666710000000002, -68.500039999999998)"
Cumberland County,Maine,281674,41,222780,40157,136684,144990,"(43.850079999999998, -70.332830000000001)"
Franklin County,Maine,30768,43.4,24721,5160,15053,15715,"(44.900060000000003, -70.449510000000004)"
Hancock County,Maine,54418,46.3,44441,9937,26641,27777,"(44.533410000000003, -68.399460000000005)"
Kennebec County,Maine,122151,42.8,96843,18960,59529,62622,"(44.466729999999998, -69.766159999999999)"
Knox County,Maine,39736,46.2,32026,7594,19663,20073,"(43.850079999999998, -69.332819999999998)"
Lincoln County,Maine,34457,48.1,27989,7393,16899,17558,"(44.133409999999998, -69.757819999999995)"
Oxford County,Maine,57833,44.6,45516,9843,28692,29141,"(44.516730000000003, -70.699510000000004)"
Penobscot County,Maine,153923,39.9,123568,22253,75853,78070,"(45.250610000000002, -68.666139999999999)"
Piscataquis County,Maine,17535,48.1,14170,3564,8694,8841,"(45.800040000000003, -69.299499999999995)"
Sagadahoc County,Maine,35293,44.1,27871,5788,17088,18205,"(43.933410000000002, -69.832819999999998)"
Somerset County,Maine,52228,43.6,41052,8537,25890,26338,"(45.250610000000002, -69.916169999999994)"
Waldo County,Maine,38786,44.1,30639,6280,19003,19783,"(44.466740000000001, -69.09948)"
Washington County,Maine,32856,46.1,26292,6426,16188,16668,"(45.000630000000001, -67.499989999999997)"
York County,Maine,197131,43,155040,30353,96076,101055,"(43.466749999999998, -70.682829999999996)"
Allegany County,Maryland,75087,40.9,61568,13402,38842,36245,"(39.66675, -78.666409999999999)"
Anne Arundel County,Maryland,537656,38.4,412595,63664,265763,271893,"(39.000109999999999, -76.616349999999997)"
Baltimore County,Maryland,805029,39.1,628279,117476,380409,424620,"(39.466769999999997, -76.649690000000007)"
Calvert County,Maryland,88737,40.1,65506,9683,43713,45024,"(38.55012, -76.583010000000002)"
Caroline County,Maryland,33066,38.700000000000003,24719,4413,16123,16943,"(38.866779999999999, -75.832989999999995)"
Carroll County,Maryland,167134,41.1,125897,21809,82510,84624,"(39.5501, -77.016369999999995)"
Cecil County,Maryland,101108,38.9,75753,11875,50301,50807,"(39.566780000000001, -75.949669999999998)"
Charles County,Maryland,146551,37.4,107667,13852,70810,75741,"(38.483460000000001, -76.983029999999999)"
Dorchester County,Maryland,32618,43.3,25550,5771,15571,17047,"(38.466790000000003, -75.999660000000006)"
Frederick County,Maryland,233385,38.6,174341,25914,114806,118579,"(39.466769999999997, -77.399709999999999)"
Garrett County,Maryland,30097,42.7,23437,5231,14949,15148,"(39.550089999999997, -79.249759999999995)"
Harford County,Maryland,244826,39.4,184416,30564,119693,125133,"(39.550109999999997, -76.299679999999995)"
Howard County,Maryland,287085,38.4,212421,29045,140593,146492,"(39.25038, -76.933030000000002)"
Kent County,Maryland,20197,45.6,16649,4397,9640,10557,"(39.300109999999997, -76.033000000000001)"
Montgomery County,Maryland,971777,38.5,738247,119769,466402,505375,"(39.150109999999998, -77.199700000000007)"
Prince George's County,Maryland,863420,34.9,657421,81513,414161,449259,"(38.833449999999999, -76.849689999999995)"
Queen Anne's County,Maryland,47798,42.6,36424,7141,23743,24055,"(39.066780000000001, -75.983000000000004)"
St. Mary's County,Maryland,105151,36,77565,10781,52321,52830,"(38.133459999999999, -75.732979999999998)"
Somerset County,Maryland,26470,36.5,22005,3660,14136,12334,"(38.133459999999999, -75.732979999999998)"
Talbot County,Maryland,37782,47.4,30407,8958,18019,19763,"(38.766779999999997, -76.082999999999998)"
Washington County,Maryland,147430,39.700000000000003,113651,21104,74877,72553,"(39.616759999999999, -77.766379999999998)"
Wicomico County,Maryland,98733,35.700000000000003,76638,12847,47087,51646,"(38.366779999999999, -75.599649999999997)"
Worcester County,Maryland,51454,48.1,42031,11961,25044,26410,"(38.200119999999998, -75.38297)"
Baltimore city,Maryland,620961,34.4,487401,72812,292249,328712,"(39.000109999999999, -76.616349999999997)"
Barnstable County,Massachusetts,215888,49.9,178639,53879,102854,113034,"(41.666780000000003, -70.249459999999999)"
Berkshire County,Massachusetts,131219,44.7,105595,24386,63169,68050,"(42.333419999999997, -73.249549999999999)"
Bristol County,Massachusetts,548285,39.799999999999997,425876,77879,265516,282769,"(41.83343, -71.166160000000005)"
Dukes County,Massachusetts,16535,45.3,13362,2699,8184,8351,"(41.333449999999999, -70.749470000000002)"
Essex County,Massachusetts,743159,40.4,571070,105083,356615,386544,"(42.666759999999996, -70.832830000000001)"
Franklin County,Massachusetts,71372,44.2,57304,10878,34810,36562,"(42.583419999999997, -72.58287)"
Hampden County,Massachusetts,463490,38.6,353605,65745,222669,240821,"(42.166759999999996, -72.58287)"
Hampshire County,Massachusetts,158080,36.6,131314,20022,73975,84105,"(42.333419999999997, -72.58287)"
Middlesex County,Massachusetts,1503085,38.5,1182646,197015,730864,772221,"(42.49982, -71.332840000000004)"
Nantucket County,Massachusetts,10172,39.4,8064,1227,5205,4967,"(41.26679, -70.082790000000003)"
Norfolk County,Massachusetts,670850,40.700000000000003,518718,97304,321087,349763,"(42.16677, -71.249499999999998)"
Plymouth County,Massachusetts,494919,41.1,375444,68846,240715,254204,"(41.833440000000003, -70.832819999999998)"
Suffolk County,Massachusetts,722023,31.5,595748,75726,347689,374334,"(42.33343, -71.082830000000001)"
Worcester County,Massachusetts,798552,39.200000000000003,611321,102035,393276,405276,"(42.33343, -71.832849999999993)"
Alcona County,Michigan,10942,55.2,9349,3441,5555,5387,"(44.683349999999997, -83.583309999999997)"
Alger County,Michigan,9601,47.3,7956,1975,5224,4377,"(46.333280000000002, -86.700159999999997)"
Allegan County,Michigan,111408,39.200000000000003,82184,14438,55473,55935,"(42.600029999999997, -85.866690000000006)"
Alpena County,Michigan,29598,45.6,23409,5765,14524,15074,"(45.033340000000003, -83.649979999999999)"
Antrim County,Michigan,23580,47.4,18616,5216,11674,11906,"(45.05001, -85.133390000000006)"
Arenac County,Michigan,15899,46.7,12704,3227,8056,7843,"(44.050020000000004, -83.916659999999993)"
Baraga County,Michigan,8860,42.9,7066,1531,4863,3997,"(46.649929999999998, -88.366799999999998)"
Barry County,Michigan,59173,41.2,44715,8611,29705,29468,"(42.60004, -85.316670000000002)"
Bay County,Michigan,107771,41.7,83819,17507,52751,55020,"(43.733359999999998, -84.016649999999998)"
Benzie County,Michigan,17525,46.2,13847,3617,8701,8824,"(44.65, -86.016760000000005)"
Berrien County,Michigan,156813,41,120141,25549,76373,80440,"(41.950040000000001, -86.416679999999999)"
Branch County,Michigan,45248,39.799999999999997,34412,6659,23840,21408,"(41.916719999999998, -85.066640000000007)"
Calhoun County,Michigan,136146,39.200000000000003,103137,20109,66519,69627,"(42.250599999999999, -85.000540000000001)"
Cass County,Michigan,52293,42.6,40035,8355,26094,26199,"(41.750599999999999, -86.000559999999993)"
Charlevoix County,Michigan,25949,45.5,20233,4833,12778,13171,"(45.216679999999997, -85.000609999999995)"
Cheboygan County,Michigan,26152,47.1,20806,5621,13015,13137,"(45.450009999999999, -84.500590000000003)"
Chippewa County,Michigan,38520,39.5,30769,5627,21220,17300,"(46.300020000000004, -84.483379999999997)"
Clare County,Michigan,30926,45.3,24459,6167,15440,15486,"(43.983350000000002, -84.850020000000001)"
Clinton County,Michigan,75382,38.4,56770,9705,37057,38325,"(42.950029999999998, -84.599990000000005)"
Crawford County,Michigan,14074,47.7,11279,2928,7062,7012,"(44.666679999999999, -84.600020000000001)"
Delta County,Michigan,37069,45.6,29331,7098,18367,18702,"(45.899970000000003, -86.916809999999998)"
Dickinson County,Michigan,26168,45.4,20559,4967,12876,13292,"(46.000509999999998, -87.866799999999998)"
Eaton County,Michigan,107759,40.299999999999997,82658,15108,52595,55164,"(42.60004, -84.849990000000005)"
Emmet County,Michigan,32694,43.1,25305,5437,16102,16592,"(45.533340000000003, -84.916719999999998)"
Genesee County,Michigan,425790,38.5,319211,58189,205271,220519,"(43.033360000000002, -83.68329)"
Gladwin County,Michigan,25692,47.7,20534,5853,12839,12853,"(43.983350000000002, -84.400009999999995)"
Gogebic County,Michigan,16427,46.8,13650,3514,8760,7667,"(46.383279999999999, -89.700159999999997)"
Grand Traverse County,Michigan,86986,41.3,67791,13028,42952,44034,"(44.683340000000001, -85.466729999999998)"
Gratiot County,Michigan,42476,38.700000000000003,33359,6271,22599,19877,"(43.283360000000002, -84.6)"
Hillsdale County,Michigan,46688,40.5,35597,7344,23170,23518,"(41.90005, -84.599950000000007)"
Houghton County,Michigan,36628,33.1,29066,5476,19823,16805,"(46.949930000000002, -88.683459999999997)"
Huron County,Michigan,33118,46.8,26276,7198,16438,16680,"(43.866680000000002, -83.033280000000005)"
Ingham County,Michigan,280895,31.4,222296,29413,136594,144301,"(42.60004, -84.383300000000006)"
Ionia County,Michigan,63905,37,48230,7253,34314,29591,"(42.950029999999998, -85.066670000000002)"
Iosco County,Michigan,25887,51,21333,6755,12767,13120,"(44.333350000000003, -83.633309999999994)"
Iron County,Michigan,11817,51.9,9796,3108,5821,5996,"(46.216619999999999, -88.566800000000001)"
Isabella County,Michigan,70311,25.1,57677,6827,34216,36095,"(43.650030000000001, -84.850020000000001)"
Jackson County,Michigan,160248,39.700000000000003,123053,22679,81710,78538,"(42.250590000000003, -84.416619999999995)"
Kalamazoo County,Michigan,250331,34.1,193405,30780,122569,127762,"(42.250599999999999, -85.55)"
Kalkaska County,Michigan,17153,43,13260,2837,8717,8436,"(44.666670000000003, -85.100049999999996)"
Kent County,Michigan,602622,34.4,444488,67104,295102,307520,"(43.033360000000002, -85.550030000000007)"
Keweenaw County,Michigan,2156,51.6,1771,518,1107,1049,"(47.366579999999999, -88.200109999999995)"
Lake County,Michigan,11539,50.1,9474,2736,5898,5641,"(43.983339999999998, -85.800060000000002)"
Lapeer County,Michigan,88319,41.6,66965,11779,44535,43784,"(43.133360000000003, -83.233279999999993)"
Leelanau County,Michigan,21708,50.3,17468,5082,10703,11005,"(44.9, -85.833420000000004)"
Lenawee County,Michigan,99892,40,76764,14580,50458,49434,"(41.90005, -84.083280000000002)"
Livingston County,Michigan,180967,40.9,134730,21644,90527,90440,"(42.600029999999997, -83.916619999999995)"
Luce County,Michigan,6631,43,5445,1185,3827,2804,"(46.466670000000001, -85.550120000000007)"
Mackinac County,Michigan,11113,49,9039,2487,5612,5501,"(46.08334, -85.000619999999998)"
Macomb County,Michigan,840978,39.9,647323,120180,408712,432266,"(42.700029999999998, -82.949929999999995)"
Manistee County,Michigan,24733,47.1,20017,5108,12806,11927,"(44.33334, -86.050079999999994)"
Marquette County,Michigan,67077,39.4,54547,9827,33894,33183,"(46.533270000000002, -87.633470000000003)"
Mason County,Michigan,28705,45.1,22465,5509,14168,14537,"(43.983339999999998, -86.250630000000001)"
Mecosta County,Michigan,42798,34,34252,6577,21487,21311,"(43.650030000000001, -85.333370000000002)"
Menominee County,Michigan,24029,46.2,18987,4587,12084,11945,"(45.56664, -87.566789999999997)"
Midland County,Michigan,83629,40.4,63774,12384,41048,42581,"(43.650030000000001, -84.4)"
Missaukee County,Michigan,14849,42.8,11253,2581,7557,7292,"(44.33334, -85.100040000000007)"
Monroe County,Michigan,152021,40.299999999999997,115344,20392,75013,77008,"(41.93338, -83.549940000000007)"
Montcalm County,Michigan,63342,39.299999999999997,48051,8942,32747,30595,"(43.333359999999999, -85.116690000000006)"
Montmorency County,Michigan,9765,52.3,8123,2637,4924,4841,"(45.033340000000003, -84.133340000000004)"
Muskegon County,Michigan,172188,38.200000000000003,129401,23352,85451,86737,"(43.300020000000004, -86.133390000000006)"
Newaygo County,Michigan,48460,40.9,36363,7528,24390,24070,"(43.550020000000004, -85.800049999999999)"
Oakland County,Michigan,1202362,40.200000000000003,920257,159124,583384,618978,"(42.666699999999999, -83.399940000000001)"
Oceana County,Michigan,26570,41.8,19964,4525,13344,13226,"(43.650010000000002, -86.250630000000001)"
Ogemaw County,Michigan,21699,47.6,17280,4765,10814,10885,"(44.333350000000003, -84.133330000000001)"
Ontonagon County,Michigan,6780,52.7,5707,1787,3496,3284,"(46.666609999999999, -89.333479999999994)"
Osceola County,Michigan,23528,41.8,17705,4008,11719,11809,"(43.983350000000002, -85.333380000000005)"
Oscoda County,Michigan,8640,49.7,6897,2034,4355,4285,"(44.666679999999999, -84.133340000000004)"
Otsego County,Michigan,24164,43.2,18629,4114,11893,12271,"(45.033349999999999, -84.566689999999994)"
Ottawa County,Michigan,263801,34.5,195064,31023,129136,134665,"(42.950020000000002, -86.000600000000006)"
Presque Isle County,Michigan,13376,51.7,11039,3498,6705,6671,"(45.350009999999997, -83.933329999999998)"
Roscommon County,Michigan,24449,53.3,20523,6849,12196,12253,"(44.333350000000003, -84.600020000000001)"
Saginaw County,Michigan,200169,39.5,153328,30601,96771,103398,"(43.333359999999999, -84.03331)"
St. Clair County,Michigan,163040,41.3,124427,23671,80724,82316,"(42.950029999999998, -84.149969999999996)"
St. Joseph County,Michigan,61295,38.700000000000003,45420,9103,30316,30979,"(42.950029999999998, -84.149969999999996)"
Sanilac County,Michigan,43114,42.8,32926,7579,21315,21799,"(43.433349999999997, -82.849940000000004)"
Schoolcraft County,Michigan,8485,48.3,6798,1802,4200,4285,"(46.216639999999998, -86.200149999999994)"
Shiawassee County,Michigan,70648,40.299999999999997,53589,10105,34921,35727,"(42.950029999999998, -84.149969999999996)"
Tuscola County,Michigan,55729,41.7,42638,8831,27946,27783,"(43.46669, -83.449950000000001)"
Van Buren County,Michigan,76258,39.799999999999997,56850,10523,37803,38455,"(42.250590000000003, -86.033349999999999)"
Washtenaw County,Michigan,344791,33.299999999999997,272838,34951,170132,174659,"(42.250590000000003, -83.849940000000004)"
Wayne County,Michigan,1820584,37.299999999999997,1358789,230703,874161,946423,"(42.250590000000003, -83.283259999999999)"
Wexford County,Michigan,32735,40.9,24767,5199,16309,16426,"(44.33334, -85.566730000000007)"
Aitkin County,Minnesota,16202,51.7,13284,4413,8205,7997,"(46.59995, -93.416899999999998)"
Anoka County,Minnesota,330844,37.1,244813,32232,165327,165517,"(45.250520000000002, -93.250780000000006)"
Becker County,Minnesota,32504,42.2,24505,5637,16314,16190,"(46.949959999999997, -95.68365)"
Beltrami County,Minnesota,44442,33.200000000000003,33334,5754,22184,22258,"(47.916620000000002, -94.900270000000006)"
Benton County,Minnesota,38451,34.1,28951,4558,19277,19174,"(45.69997, -93.983590000000007)"
Big Stone County,Minnesota,5269,48.5,4164,1324,2575,2694,"(45.39996, -96.450339999999997)"
Blue Earth County,Minnesota,64013,29.8,51632,7562,32209,31804,"(44.033299999999997, -94.066900000000004)"
Brown County,Minnesota,25893,43.3,20195,4899,12856,13037,"(44.233289999999997, -94.683589999999995)"
Carlton County,Minnesota,35386,40.5,27022,5317,18413,16973,"(46.583280000000002, -92.66686)"
Carver County,Minnesota,91042,36.299999999999997,63837,7707,45236,45806,"(44.799959999999999, -93.783569999999997)"
Cass County,Minnesota,28567,46.9,22364,6029,14603,13964,"(46.916620000000002, -94.283590000000004)"
Chippewa County,Minnesota,12441,43.1,9527,2400,6102,6339,"(45.033290000000001, -95.583640000000003)"
Chisago County,Minnesota,53887,39,40040,6247,27740,26147,"(45.500520000000002, -92.900220000000004)"
Clay County,Minnesota,58999,31.6,45255,7078,29137,29862,"(46.883290000000002, -96.483680000000007)"
Clearwater County,Minnesota,8695,41.9,6525,1621,4374,4321,"(47.56662, -95.366960000000006)"
Cook County,Minnesota,5176,49.8,4305,1051,2584,2592,"(47.916559999999997, -90.550110000000004)"
Cottonwood County,Minnesota,11687,44.2,8896,2482,5763,5924,"(44.000509999999998, -95.200270000000003)"
Crow Wing County,Minnesota,62500,42.4,48128,11564,31133,31367,"(46.466630000000002, -94.083600000000004)"
Dakota County,Minnesota,398552,36.799999999999997,293492,39816,195661,202891,"(44.666629999999998, -93.066879999999998)"
Dodge County,Minnesota,20087,36.4,14263,2460,10039,10048,"(44.033299999999997, -92.866860000000003)"
Douglas County,Minnesota,36009,43.1,28133,7069,18057,17952,"(45.93329, -95.450320000000005)"
Faribault County,Minnesota,14553,46,11354,3179,7231,7322,"(43.666620000000002, -93.93356)"
Fillmore County,Minnesota,20866,42.8,15801,4000,10370,10496,"(43.666629999999998, -92.100160000000002)"
Freeborn County,Minnesota,31255,44.2,24383,6309,15462,15793,"(43.666620000000002, -93.350210000000004)"
Goodhue County,Minnesota,46183,41.9,35233,7594,22927,23256,"(44.416629999999998, -92.716859999999997)"
Grant County,Minnesota,6018,46.5,4731,1334,2974,3044,"(45.93329, -96.000889999999998)"
Hennepin County,Minnesota,1152425,35.9,891080,130814,566184,586241,"(45.016629999999999, -93.450230000000005)"
Houston County,Minnesota,19027,43.8,14624,3307,9437,9590,"(43.666640000000001, -91.500699999999995)"
Hubbard County,Minnesota,20428,46.4,15964,4245,10288,10140,"(47.099960000000003, -94.900289999999998)"
Isanti County,Minnesota,37816,37.6,28011,4680,19065,18751,"(45.549959999999999, -93.300229999999999)"
Itasca County,Minnesota,45058,45.4,35222,8574,22747,22311,"(47.500500000000002, -93.583529999999996)"
Jackson County,Minnesota,10266,44.1,7946,2044,5190,5076,"(43.625509999999998, -94.874709999999993)"
Kanabec County,Minnesota,16239,42.1,12343,2659,8221,8018,"(45.949959999999997, -93.300219999999996)"
Kandiyohi County,Minnesota,42239,39.5,32082,6832,21078,21161,"(45.133299999999998, -95.000839999999997)"
Kittson County,Minnesota,4552,48.2,3568,1029,2286,2266,"(48.766649999999998, -96.783659999999998)"
Koochiching County,Minnesota,13311,46.4,10529,2604,6608,6703,"(48.233289999999997, -93.783510000000007)"
Lac qui Parle County,Minnesota,7259,48.9,5725,1726,3629,3630,"(44.966630000000002, -96.150319999999994)"
Lake County,Minnesota,10866,48.3,8799,2428,5479,5387,"(47.633240000000001, -91.416820000000001)"
Lake of the Woods County,Minnesota,4045,48.7,3231,821,2068,1977,"(48.750540000000001, -94.916880000000006)"
Le Sueur County,Minnesota,27703,39.799999999999997,20651,3976,13988,13715,"(44.383299999999998, -93.73357)"
Lincoln County,Minnesota,5896,46.2,4580,1444,2960,2936,"(44.416629999999998, -96.266990000000007)"
Lyon County,Minnesota,25857,34.1,19592,3519,12845,13012,"(44.416629999999998, -95.850300000000004)"
McLeod County,Minnesota,36651,39.1,27386,5603,18277,18374,"(44.833300000000001, -94.250810000000001)"
Mahnomen County,Minnesota,5413,37.4,3827,855,2752,2661,"(47.333289999999998, -95.816980000000001)"
Marshall County,Minnesota,9439,44.1,7213,1816,4781,4658,"(48.349969999999999, -96.366979999999998)"
Martin County,Minnesota,20840,45.5,16208,4317,10229,10611,"(43.666620000000002, -94.550250000000005)"
Meeker County,Minnesota,23300,41.2,17380,3835,11833,11467,"(45.133299999999998, -94.516940000000005)"
Mille Lacs County,Minnesota,26097,39.4,19482,4206,13102,12995,"(45.583300000000001, -93.758579999999995)"
Morrison County,Minnesota,33198,40.6,25033,5325,16746,16452,"(46.016629999999999, -94.300280000000001)"
Mower County,Minnesota,39163,39.200000000000003,29280,6818,19497,19666,"(43.666629999999998, -92.766850000000005)"
Murray County,Minnesota,8725,46.8,6791,1951,4327,4398,"(44.033299999999997, -95.766959999999997)"
Nicollet County,Minnesota,32727,34.1,25344,3917,16364,16363,"(44.349969999999999, -94.283580000000001)"
Nobles County,Minnesota,21378,37.5,15895,3420,10917,10461,"(43.666629999999998, -95.766959999999997)"
Norman County,Minnesota,6852,45.2,5186,1465,3417,3435,"(47.333300000000001, -96.467010000000002)"
Olmsted County,Minnesota,144248,36.299999999999997,107808,18133,70485,73763,"(44.000520000000002, -92.450180000000003)"
Otter Tail County,Minnesota,57303,46.3,44846,12032,28724,28579,"(46.39996, -95.700320000000005)"
Pennington County,Minnesota,13930,38.9,10619,2212,6870,7060,"(48.066630000000004, -96.033640000000005)"
Pine County,Minnesota,29750,41.6,23151,4856,15934,13816,"(46.083280000000002, -92.250749999999996)"
Pipestone County,Minnesota,9596,42.3,7205,1901,4669,4927,"(44.033299999999997, -96.266980000000004)"
Polk County,Minnesota,31600,39.799999999999997,24079,5220,15823,15777,"(47.750529999999998, -96.583680000000001)"
Pope County,Minnesota,10995,45.9,8658,2338,5557,5438,"(45.566630000000004, -95.450310000000002)"
Ramsey County,Minnesota,508640,34.6,390147,61181,246642,261998,"(45.033299999999997, -93.083550000000002)"
Red Lake County,Minnesota,4089,41.9,3082,701,2083,2006,"(47.883299999999998, -96.083650000000006)"
Redwood County,Minnesota,16059,42.6,12042,3164,7963,8096,"(44.416620000000002, -95.233609999999999)"
Renville County,Minnesota,15730,44.2,12074,3045,7948,7782,"(44.716630000000002, -94.966939999999994)"
Rice County,Minnesota,64142,35,48979,7881,32796,31346,"(44.349960000000003, -93.333550000000002)"
Rock County,Minnesota,9687,41.4,7184,1835,4788,4899,"(43.666629999999998, -96.100300000000004)"
Roseau County,Minnesota,15629,40.700000000000003,11525,2250,7980,7649,"(48.78331, -95.800269999999998)"
St. Louis County,Minnesota,200226,40.799999999999997,160667,31816,100207,100019,"(44.566630000000004, -94.200249999999997)"
Scott County,Minnesota,129928,34.799999999999997,90700,10016,64715,65213,"(44.633299999999998, -93.500789999999995)"
Sherburne County,Minnesota,88499,33.9,62722,7307,45273,43226,"(45.44997, -93.766919999999999)"
Sibley County,Minnesota,15226,40.299999999999997,11323,2479,7648,7578,"(44.566630000000004, -94.200249999999997)"
Stearns County,Minnesota,150642,33.299999999999997,115742,18228,75933,74709,"(45.549959999999999, -94.550280000000001)"
Steele County,Minnesota,36576,38.5,26926,5270,18108,18468,"(44.033299999999997, -93.133539999999996)"
Stevens County,Minnesota,9726,33.9,7689,1597,4799,4927,"(45.566630000000004, -96.000889999999998)"
Swift County,Minnesota,9783,44.4,7600,1966,4925,4858,"(45.266629999999999, -95.666979999999995)"
Todd County,Minnesota,24895,41.9,18685,4327,12746,12149,"(46.066630000000004, -94.883629999999997)"
Traverse County,Minnesota,3558,47.6,2780,937,1767,1791,"(45.799959999999999, -96.433679999999995)"
Wabasha County,Minnesota,21676,42.8,16623,3692,10866,10810,"(44.283299999999997, -92.216840000000005)"
Wadena County,Minnesota,13843,43.3,10517,2918,6831,7012,"(46.583289999999998, -94.966970000000003)"
Waseca County,Minnesota,19136,39.299999999999997,14613,2819,8976,10160,"(44.033299999999997, -93.583560000000006)"
Washington County,Minnesota,238136,38.299999999999997,174538,24984,117804,120332,"(45.033299999999997, -92.916880000000006)"
Watonwan County,Minnesota,11211,41.2,8403,2125,5612,5599,"(43.966619999999999, -94.616919999999993)"
Wilkin County,Minnesota,6576,43.5,5002,1169,3335,3241,"(46.250520000000002, -96.467010000000002)"
Winona County,Minnesota,51461,33.1,41492,6891,25307,26154,"(43.966630000000002, -91.766819999999996)"
Wright County,Minnesota,124700,34.6,87339,11934,62622,62078,"(45.183300000000003, -93.950249999999997)"
Yellow Medicine County,Minnesota,10438,42.9,7963,2031,5328,5110,"(44.716619999999999, -95.800299999999993)"
Adams County,Mississippi,32297,41.1,25102,5116,16129,16168,"(31.547940000000001, -91.355950000000007)"
Alcorn County,Mississippi,37057,39.200000000000003,28036,5888,18111,18946,"(34.906759999999998, -88.53116)"
Amite County,Mississippi,13131,43.7,10176,2390,6374,6757,"(31.175450000000001, -90.838710000000006)"
Attala County,Mississippi,19564,39.6,14478,3369,9303,10261,"(33.057070000000003, -89.592020000000005)"
Benton County,Mississippi,8729,39.4,6572,1343,4287,4442,"(34.821480000000001, -89.190629999999999)"
Bolivar County,Mississippi,34145,34,25502,4113,15876,18269,"(33.782890000000002, -90.791210000000007)"
Calhoun County,Mississippi,14962,39.700000000000003,11223,2476,7153,7809,"(33.932609999999997, -89.330349999999996)"
Carroll County,Mississippi,10597,43.3,8314,1817,5296,5301,"(33.45373, -89.901470000000003)"
Chickasaw County,Mississippi,17392,37.700000000000003,12820,2512,8267,9125,"(33.933450000000001, -88.914500000000004)"
Choctaw County,Mississippi,8547,41.9,6470,1486,4094,4453,"(33.340400000000002, -89.237570000000005)"
Claiborne County,Mississippi,9604,33.299999999999997,7335,1165,4519,5085,"(31.940989999999999, -90.948160000000001)"
Clarke County,Mississippi,16732,40.5,12604,2741,7960,8772,"(32.055149999999998, -88.71754)"
Clay County,Mississippi,20634,37.799999999999997,15332,2952,9670,10964,"(33.622900000000001, -88.700329999999994)"
Coahoma County,Mississippi,26151,32.799999999999997,18487,3186,12003,14148,"(34.217889999999997, -90.567880000000002)"
Copiah County,Mississippi,29449,36.700000000000003,22065,4029,14238,15211,"(31.891829999999999, -90.384259999999998)"
Covington County,Mississippi,19568,37.6,14481,2957,9517,10051,"(31.648219999999998, -89.552850000000007)"
DeSoto County,Mississippi,161252,35,115627,16341,78595,82657,"(34.924819999999997, -89.990369999999999)"
Forrest County,Mississippi,74934,31.3,57231,8664,35850,39084,"(31.314340000000001, -89.294229999999999)"
Franklin County,Mississippi,8118,40.1,6075,1315,3942,4176,"(31.472950000000001, -90.893990000000002)"
George County,Mississippi,22578,36.4,16518,2879,11421,11157,"(30.89019, -88.596410000000006)"
Greene County,Mississippi,14400,36.6,11244,1617,8510,5890,"(31.1999, -88.661689999999993)"
Grenada County,Mississippi,21906,39.4,16515,3277,10336,11570,"(33.774000000000001, -89.808419999999998)"
Hancock County,Mississippi,43929,40.700000000000003,33431,6685,21801,22128,"(30.351579999999998, -89.398380000000003)"
Harrison County,Mississippi,187105,35.299999999999997,141252,21952,93033,94072,"(30.409089999999999, -89.04365)"
Hinds County,Mississippi,245285,33.1,180242,26551,115203,130082,"(32.313200000000002, -90.244259999999997)"
Holmes County,Mississippi,19198,32.799999999999997,13621,2422,8983,10215,"(33.098739999999999, -90.049809999999994)"
Humphreys County,Mississippi,9375,34.4,6673,1169,4390,4985,"(33.160400000000003, -90.522310000000004)"
Issaquena County,Mississippi,1406,38.4,1125,203,816,590,"(32.842910000000003, -90.979550000000003)"
Itawamba County,Mississippi,23401,38.5,18001,3701,11442,11959,"(34.2926, -88.400599999999997)"
Jackson County,Mississippi,139668,37.200000000000003,104068,17341,68850,70818,"(30.423249999999999, -88.627799999999993)"
Jasper County,Mississippi,17062,40.6,12939,2735,8230,8832,"(31.973210000000002, -89.126720000000006)"
Jefferson County,Mississippi,7726,37.6,5901,998,3829,3897,"(31.717939999999999, -91.050939999999997)"
Jefferson Davis County,Mississippi,12487,41,9539,2068,5965,6522,"(31.573219999999999, -89.823970000000003)"
Jones County,Mississippi,67761,36.799999999999997,50413,9748,33020,34741,"(31.67266, -89.157560000000004)"
Kemper County,Mississippi,10456,38.5,8015,1635,5111,5345,"(32.752079999999999, -88.666430000000005)"
Lafayette County,Mississippi,47351,27.7,38591,4958,23384,23967,"(34.365940000000002, -89.519530000000003)"
Lamar County,Mississippi,55658,33,41050,6008,26919,28739,"(31.230180000000001, -89.455070000000006)"
Lauderdale County,Mississippi,80261,37,60181,11318,38676,41585,"(32.398200000000003, -88.691159999999996)"
Lawrence County,Mississippi,12929,38.9,9663,1922,6347,6582,"(31.573779999999999, -90.110640000000004)"
Leake County,Mississippi,23805,33.200000000000003,16443,3101,12350,11455,"(32.732080000000003, -89.510069999999999)"
Lee County,Mississippi,82910,36.4,60804,10749,39709,43201,"(34.26455, -88.706999999999994)"
Leflore County,Mississippi,32317,32.799999999999997,23566,3848,15512,16805,"(33.519840000000002, -90.223140000000001)"
Lincoln County,Mississippi,34869,37.799999999999997,25766,4944,16682,18187,"(31.552119999999999, -90.450100000000006)"
Lowndes County,Mississippi,59779,36,44724,7704,28341,31438,"(33.517060000000001, -88.401709999999994)"
Madison County,Mississippi,95203,35.799999999999997,69555,9917,45612,49591,"(32.56514, -90.064530000000005)"
Marion County,Mississippi,27088,37.700000000000003,20156,3977,13092,13996,"(31.24212, -89.838970000000003)"
Marshall County,Mississippi,37144,38.299999999999997,28441,4727,18398,18746,"(34.802599999999998, -89.530910000000006)"
Monroe County,Mississippi,36989,39.5,27907,5830,17582,19407,"(33.916499999999999, -88.497540000000001)"
Montgomery County,Mississippi,10925,41.4,8255,1878,5194,5731,"(33.489289999999997, -89.672579999999996)"
Neshoba County,Mississippi,29676,35.299999999999997,21161,3996,14231,15445,"(32.757080000000002, -89.113950000000003)"
Newton County,Mississippi,21720,37.1,16067,3233,10412,11308,"(32.410139999999998, -89.126170000000002)"
Noxubee County,Mississippi,11545,36.299999999999997,8416,1552,5526,6019,"(33.129010000000001, -88.555880000000002)"
Oktibbeha County,Mississippi,47671,25.4,38965,4391,23752,23919,"(33.438180000000003, -88.83005)"
Panola County,Mississippi,34707,36.5,25363,4411,16683,18024,"(34.363160000000001, -89.962310000000002)"
Pearl River County,Mississippi,55834,38.9,42102,8136,27569,28265,"(30.642690000000002, -89.641450000000006)"
Perry County,Mississippi,12250,38.700000000000003,9136,1732,5984,6266,"(31.254899999999999, -88.974490000000003)"
Pike County,Mississippi,40404,36.9,29433,5731,19232,21172,"(31.209620000000001, -90.435929999999999)"
Pontotoc County,Mississippi,29957,36.4,21877,3831,14771,15186,"(34.238720000000001, -89.020060000000001)"
Prentiss County,Mississippi,25276,38.5,19391,3972,12353,12923,"(34.632040000000003, -88.557829999999996)"
Quitman County,Mississippi,8223,37.299999999999997,6070,1156,3929,4294,"(34.261499999999998, -90.27704)"
Rankin County,Mississippi,141617,36.200000000000003,106083,16236,68525,73092,"(32.264310000000002, -90.040639999999996)"
Scott County,Mississippi,28264,34.9,20630,3512,13828,14436,"(32.39264, -89.524510000000006)"
Sharkey County,Mississippi,4916,39.5,3660,707,2251,2665,"(32.92013, -90.850930000000005)"
Simpson County,Mississippi,27503,37.9,20252,3848,13339,14164,"(31.904599999999999, -89.847020000000001)"
Smith County,Mississippi,16491,39.1,12230,2520,8028,8463,"(31.97099, -89.498400000000004)"
Stone County,Mississippi,17786,35.9,13455,2144,8905,8881,"(30.814630000000001, -89.133099999999999)"
Sunflower County,Mississippi,29450,33.5,22303,2995,15726,13724,"(33.569839999999999, -90.60454)"
Tallahatchie County,Mississippi,15378,35,11893,1816,8433,6945,"(33.962609999999998, -90.185090000000002)"
Tate County,Mississippi,28886,36,21427,3577,13960,14926,"(34.65455, -89.938980000000001)"
Tippah County,Mississippi,22232,38,16589,3255,10861,11371,"(34.776479999999999, -88.926450000000003)"
Tishomingo County,Mississippi,19593,42,15055,3534,9462,10131,"(34.727040000000002, -88.226429999999993)"
Tunica County,Mississippi,10778,32.1,7561,1019,5092,5686,"(34.6676, -90.363709999999998)"
Union County,Mississippi,27134,37.5,20144,3923,13255,13879,"(34.482880000000002, -89.017009999999999)"
Walthall County,Mississippi,15443,38,11368,2445,7502,7941,"(31.147680000000001, -90.119810000000001)"
Warren County,Mississippi,48773,37.700000000000003,36135,6258,23167,25606,"(32.31709, -90.857879999999994)"
Washington County,Mississippi,51137,35.299999999999997,36800,6295,23803,27334,"(33.370669999999997, -91.006770000000003)"
Wayne County,Mississippi,20747,37.200000000000003,15313,2884,9958,10789,"(31.659880000000001, -88.660870000000003)"
Webster County,Mississippi,10253,39.9,7674,1614,4985,5268,"(33.586790000000001, -89.251729999999995)"
Wilkinson County,Mississippi,9878,37.5,7607,1364,5228,4650,"(31.127400000000002, -91.261219999999994)"
Winston County,Mississippi,19198,39.5,14409,3171,9239,9959,"(33.089019999999998, -89.049779999999998)"
Yalobusha County,Mississippi,12678,40.6,9656,2098,6053,6625,"(34.074829999999999, -89.691749999999999)"
Yazoo County,Mississippi,28065,35.1,20988,3329,15276,12789,"(32.825409999999998, -90.378420000000006)"
Adair County,Missouri,25607,28.3,20635,3210,12204,13403,"(40.200029999999998, -92.600189999999998)"
Andrew County,Missouri,17291,41,13127,2681,8513,8778,"(39.983330000000002, -94.800240000000002)"
Atchison County,Missouri,5685,46.2,4503,1227,2818,2867,"(40.433329999999998, -95.400260000000003)"
Audrain County,Missouri,25529,38.5,19160,4084,11798,13731,"(39.216709999999999, -91.866839999999996)"
Barry County,Missouri,35597,41.8,26957,6271,17670,17927,"(36.733400000000003, -93.733530000000002)"
Barton County,Missouri,12402,40.299999999999997,9188,2132,6113,6289,"(37.500329999999998, -94.350229999999996)"
Bates County,Missouri,17049,41.3,12795,3019,8407,8642,"(38.250300000000003, -94.350229999999996)"
Benton County,Missouri,19056,51.5,15619,4936,9544,9512,"(38.300020000000004, -93.300200000000004)"
Bollinger County,Missouri,12363,42,9446,2059,6187,6176,"(37.333390000000001, -90.033439999999999)"
Boone County,Missouri,162642,29.6,128391,15072,78950,83692,"(39.033369999999998, -92.333519999999993)"
Buchanan County,Missouri,89201,36.9,68238,12501,44586,44615,"(39.65, -94.766909999999996)"
Butler County,Missouri,42794,40.6,32823,7265,20620,22174,"(36.716720000000002, -90.400109999999998)"
Caldwell County,Missouri,9424,41.3,7020,1576,4727,4697,"(39.650010000000002, -94.000500000000002)"
Callaway County,Missouri,44332,37.700000000000003,34329,5460,22766,21566,"(38.866709999999998, -91.900180000000006)"
Camden County,Missouri,44002,48.6,35612,9534,21871,22131,"(38.033369999999998, -92.766850000000005)"
Cape Girardeau County,Missouri,75674,36.4,59075,10834,36612,39062,"(37.383380000000002, -89.716759999999994)"
Carroll County,Missouri,9295,42.1,7103,1779,4536,4759,"(39.450020000000002, -93.51688)"
Carter County,Missouri,6265,41.2,4750,1040,3055,3210,"(36.950049999999997, -90.933459999999997)"
Cass County,Missouri,99478,37.9,73093,13490,48595,50883,"(38.650010000000002, -94.366889999999998)"
Cedar County,Missouri,13982,44.9,10674,3126,6876,7106,"(37.733370000000001, -93.866879999999995)"
Chariton County,Missouri,7831,45.8,6062,1675,3861,3970,"(39.516689999999997, -92.950190000000006)"
Christian County,Missouri,77422,36.299999999999997,56236,9464,37640,39782,"(36.966720000000002, -93.183520000000001)"
Clark County,Missouri,7139,42.3,5422,1261,3568,3571,"(40.433369999999996, -91.716830000000002)"
Clay County,Missouri,221939,36.200000000000003,164672,24964,108361,113578,"(39.316670000000002, -94.400229999999993)"
Clinton County,Missouri,20743,40.799999999999997,15649,3260,10413,10330,"(39.6, -94.400229999999993)"
Cole County,Missouri,75990,37.700000000000003,58053,9325,38340,37650,"(38.500309999999999, -92.283519999999996)"
Cooper County,Missouri,17601,38.700000000000003,13622,2702,9267,8334,"(38.850020000000001, -92.800190000000001)"
Crawford County,Missouri,24696,40.6,18695,4017,12291,12405,"(37.966709999999999, -91.283479999999997)"
Dade County,Missouri,7883,45.9,6098,1617,3953,3930,"(37.43338, -93.850210000000004)"
Dallas County,Missouri,16777,41.4,12608,2853,8341,8436,"(37.683369999999996, -93.016850000000005)"
Daviess County,Missouri,8433,40.1,6181,1441,4191,4242,"(39.966670000000001, -94.000500000000002)"
DeKalb County,Missouri,12892,39.9,10582,1771,8086,4806,"(39.883330000000001, -94.416899999999998)"
Dent County,Missouri,15657,43,12005,2977,7766,7891,"(37.633380000000002, -91.516810000000007)"
Douglas County,Missouri,13684,45,10623,2716,6754,6930,"(36.950060000000001, -92.483500000000006)"
Dunklin County,Missouri,31953,39.299999999999997,23869,5268,15344,16609,"(36.2834, -90.033429999999996)"
Franklin County,Missouri,101492,39.4,76388,14000,50303,51189,"(38.43338, -91.066810000000004)"
Gasconade County,Missouri,15222,45,11858,3062,7459,7763,"(38.450049999999997, -91.500439999999998)"
Gentry County,Missouri,6738,42.4,5084,1381,3258,3480,"(40.216659999999997, -94.416899999999998)"
Greene County,Missouri,275174,35.799999999999997,216801,38593,134066,141108,"(37.266710000000003, -93.350189999999998)"
Grundy County,Missouri,10261,41.6,7794,2100,4895,5366,"(40.116680000000002, -93.566879999999998)"
Harrison County,Missouri,8957,42.6,6736,1854,4444,4513,"(40.466670000000001, -94.000510000000006)"
Henry County,Missouri,22272,43.5,17316,4345,10890,11382,"(38.38335, -93.783550000000005)"
Hickory County,Missouri,9627,53,7962,2846,4731,4896,"(37.950029999999998, -93.300200000000004)"
Holt County,Missouri,4912,46.6,3941,1043,2426,2486,"(40.1, -95.216920000000002)"
Howard County,Missouri,10144,39.200000000000003,7966,1609,5041,5103,"(39.150030000000001, -92.683520000000001)"
Howell County,Missouri,40400,39.6,30336,6909,19549,20851,"(36.783389999999997, -91.883480000000006)"
Iron County,Missouri,10630,42.7,8227,1899,5250,5380,"(37.583379999999998, -90.700119999999998)"
Jackson County,Missouri,674158,36.200000000000003,508523,83990,325853,348305,"(39.016669999999998, -94.350229999999996)"
Jasper County,Missouri,117404,35.1,87125,15714,57292,60112,"(37.200060000000001, -94.350219999999993)"
Jefferson County,Missouri,218733,37.799999999999997,163745,24394,108846,109887,"(38.266719999999999, -90.583460000000002)"
Johnson County,Missouri,52595,29.8,40552,5644,26547,26048,"(38.75029, -93.800219999999996)"
Knox County,Missouri,4131,43.6,3099,828,2032,2099,"(40.133369999999999, -92.150180000000006)"
Laclede County,Missouri,35571,39.299999999999997,26664,5556,17527,18044,"(37.650039999999997, -92.600170000000006)"
Lafayette County,Missouri,33381,40.6,25194,5495,16479,16902,"(39.066679999999998, -93.783550000000005)"
Lawrence County,Missouri,38634,39.1,28459,6300,19032,19602,"(37.116720000000001, -93.833539999999999)"
Lewis County,Missouri,10211,38.700000000000003,7816,1664,5118,5093,"(40.10004, -91.716830000000002)"
Lincoln County,Missouri,52566,35.6,37840,5715,26208,26358,"(39.06671, -90.966800000000006)"
Linn County,Missouri,12761,42.2,9605,2430,6137,6624,"(39.866689999999998, -93.116870000000006)"
Livingston County,Missouri,15195,41.1,11866,2766,6801,8394,"(39.750300000000003, -93.550210000000007)"
McDonald County,Missouri,23083,36.5,16608,2887,11661,11422,"(36.633409999999998, -94.350210000000004)"
Macon County,Missouri,15566,42.3,11787,3026,7615,7951,"(39.833370000000002, -92.550190000000001)"
Madison County,Missouri,12226,41,9295,2167,6009,6217,"(37.48339, -90.350120000000004)"
Maries County,Missouri,9176,42.8,7022,1646,4638,4538,"(38.166710000000002, -91.883499999999998)"
Marion County,Missouri,28781,39,21893,4507,13854,14927,"(39.81671, -91.600160000000002)"
Mercer County,Missouri,3785,43.5,2822,763,1903,1882,"(40.433340000000001, -93.566890000000001)"
Miller County,Missouri,24748,40.200000000000003,18604,3897,12314,12434,"(38.216700000000003, -92.433509999999998)"
Mississippi County,Missouri,14358,39.4,11170,2188,7692,6666,"(36.816719999999997, -89.316739999999996)"
Moniteau County,Missouri,15607,37.799999999999997,11681,2153,8229,7378,"(38.616689999999998, -92.566860000000005)"
Monroe County,Missouri,8840,43.8,6779,1648,4416,4424,"(39.500320000000002, -91.983500000000006)"
Montgomery County,Missouri,12236,43.2,9383,2286,6118,6118,"(38.966709999999999, -91.483490000000003)"
Morgan County,Missouri,20565,46.1,16031,4535,10246,10319,"(38.416690000000003, -92.866860000000003)"
New Madrid County,Missouri,18956,40.4,14442,3045,9108,9848,"(36.583390000000001, -89.616749999999996)"
Newton County,Missouri,58114,39,43352,8857,28833,29281,"(36.916730000000001, -94.350219999999993)"
Nodaway County,Missouri,23370,28.5,19107,3077,11848,11522,"(40.349989999999998, -94.866919999999993)"
Oregon County,Missouri,10881,45.4,8455,2153,5395,5486,"(36.73339, -91.416799999999995)"
Osage County,Missouri,13878,39.299999999999997,10445,2077,7219,6659,"(38.450040000000001, -91.866839999999996)"
Ozark County,Missouri,9723,48.9,7774,2279,4909,4814,"(36.650060000000003, -92.450159999999997)"
Pemiscot County,Missouri,18296,37,13262,2693,8696,9600,"(36.233400000000003, -89.816749999999999)"
Perry County,Missouri,18971,39.200000000000003,14209,2960,9462,9509,"(37.700049999999997, -89.833439999999996)"
Pettis County,Missouri,42201,37.1,31417,6203,20747,21454,"(38.733350000000002, -93.300210000000007)"
Phelps County,Missouri,45156,33.799999999999997,35364,6157,23618,21538,"(37.900039999999997, -91.833489999999998)"
Pike County,Missouri,18516,39.9,14409,2883,10150,8366,"(39.366709999999998, -91.166809999999998)"
Platte County,Missouri,89322,38.4,67326,9967,43960,45362,"(39.416670000000003, -94.800240000000002)"
Polk County,Missouri,31137,37.799999999999997,23471,5025,15361,15776,"(37.616709999999998, -93.400199999999998)"
Pulaski County,Missouri,52274,26.6,39737,3768,29212,23062,"(37.833370000000002, -92.20017)"
Putnam County,Missouri,4979,45.1,3819,1076,2476,2503,"(40.483350000000002, -93.016869999999997)"
Ralls County,Missouri,10167,43.4,7789,1676,5141,5026,"(39.533380000000001, -91.633489999999995)"
Randolph County,Missouri,25414,38,19535,3605,13296,12118,"(39.433369999999996, -92.500460000000004)"
Ray County,Missouri,23494,40.6,17627,3483,11707,11787,"(39.366680000000002, -94.000500000000002)"
Reynolds County,Missouri,6696,44.6,5164,1343,3414,3282,"(37.383380000000002, -90.983459999999994)"
Ripley County,Missouri,14100,42.1,10793,2646,6984,7116,"(36.650060000000003, -90.850120000000004)"
St. Charles County,Missouri,360485,36.9,267625,40378,176922,183563,"(39.766710000000003, -92.016840000000002)"
St. Clair County,Missouri,9805,48.1,7845,2295,4947,4858,"(39.766710000000003, -92.016840000000002)"
Ste. Genevieve County,Missouri,18145,42.6,13924,2911,9167,8978,"(39.766710000000003, -92.016840000000002)"
St. Francois County,Missouri,65359,38.200000000000003,50951,9354,34794,30565,"(39.766710000000003, -92.016840000000002)"
St. Louis County,Missouri,998954,39.9,764780,149493,472903,526051,"(39.766710000000003, -92.016840000000002)"
Saline County,Missouri,23370,38.200000000000003,17974,3699,11577,11793,"(39.133360000000003, -93.21687)"
Schuyler County,Missouri,4431,41.3,3291,870,2155,2276,"(40.466700000000003, -92.533519999999996)"
Scotland County,Missouri,4843,39.1,3481,879,2355,2488,"(40.450029999999998, -92.150180000000006)"
Scott County,Missouri,39191,38.9,29341,5872,18879,20312,"(37.066719999999997, -89.566749999999999)"
Shannon County,Missouri,8441,43.4,6470,1462,4206,4235,"(37.15005, -91.383470000000003)"
Shelby County,Missouri,6373,42.3,4776,1239,3125,3248,"(39.766710000000003, -92.016840000000002)"
Stoddard County,Missouri,29968,41.1,23137,5346,14552,15416,"(36.766719999999999, -89.883420000000001)"
Stone County,Missouri,32202,49.9,26170,7870,15868,16334,"(36.750340000000001, -93.466859999999997)"
Sullivan County,Missouri,6714,40.799999999999997,5089,1144,3433,3281,"(40.21669, -93.116879999999995)"
Taney County,Missouri,51675,40.700000000000003,40248,9150,25150,26525,"(36.650060000000003, -93.050179999999997)"
Texas County,Missouri,26008,42.1,20287,4682,13529,12479,"(37.31671, -91.966819999999998)"
Vernon County,Missouri,21159,40,15896,3476,10269,10890,"(37.85004, -94.350229999999996)"
Warren County,Missouri,32513,39.5,24387,4749,16199,16314,"(38.766710000000003, -91.166820000000001)"
Washington County,Missouri,25195,39.200000000000003,19132,3378,12924,12271,"(37.950049999999997, -90.883470000000003)"
Wayne County,Missouri,13521,45.8,10715,2895,6773,6748,"(37.133380000000002, -90.483450000000005)"
Webster County,Missouri,36202,37.5,26163,4752,18298,17904,"(37.266719999999999, -92.866839999999996)"
Worth County,Missouri,2171,47.4,1727,514,1066,1105,"(40.483319999999999, -94.416899999999998)"
Wright County,Missouri,18815,40.700000000000003,13943,3291,9176,9639,"(37.266719999999999, -92.483500000000006)"
St. Louis city,Missouri,319294,33.9,251755,35175,154171,165123,"(39.766710000000003, -92.016840000000002)"
Beaverhead County,Montana,9246,42,7386,1565,4731,4515,"(45.166589999999999, -112.91753)"
Big Horn County,Montana,12865,30.5,8597,1290,6394,6471,"(45.44997, -107.46731)"
Blaine County,Montana,6491,35.1,4542,877,3248,3243,"(48.41666, -109.03406)"
Broadwater County,Montana,5612,45.4,4350,997,2871,2741,"(46.349930000000001, -111.48412999999999)"
Carbon County,Montana,10078,48.1,8092,1895,5105,4973,"(45.216610000000003, -109.06737)"
Carter County,Montana,1160,50.2,957,269,586,574,"(45.466659999999997, -104.55051)"
Cascade County,Montana,81327,38.9,62697,12690,40568,40759,"(47.299950000000003, -111.36745999999999)"
Chouteau County,Montana,5813,41.5,4262,1008,2861,2952,"(47.866639999999997, -110.46742999999999)"
Custer County,Montana,11699,42.1,9042,2044,5810,5889,"(46.283340000000003, -105.58387999999999)"
Daniels County,Montana,1751,50.4,1383,435,881,870,"(48.783360000000002, -105.53389)"
Dawson County,Montana,8966,43.5,7097,1606,4532,4434,"(47.266680000000001, -104.90052)"
Deer Lodge County,Montana,9298,46,7540,1782,4921,4377,"(46.049930000000003, -113.03421)"
Fallon County,Montana,2890,42.9,2211,504,1466,1424,"(46.35, -104.45050000000001)"
Fergus County,Montana,11586,47.8,9246,2490,5821,5765,"(47.299979999999998, -109.26739999999999)"
Flathead County,Montana,90928,41.2,69674,13103,45276,45652,"(48.333300000000001, -114.25124)"
Gallatin County,Montana,89513,32.5,70780,8470,46462,43051,"(45.666600000000003, -111.20079)"
Garfield County,Montana,1206,46.4,927,248,617,589,"(47.3, -106.96729000000001)"
Glacier County,Montana,13399,31.7,9163,1414,6555,6844,"(48.649979999999999, -112.96758)"
Golden Valley County,Montana,884,48.8,692,189,463,421,"(46.366630000000001, -109.18406)"
Granite County,Montana,3079,52.1,2555,753,1567,1512,"(46.399920000000002, -113.46758)"
Hill County,Montana,16096,35.1,11786,2038,8122,7974,"(48.65, -110.10077)"
Jefferson County,Montana,11406,46.2,8775,1605,5814,5592,"(46.183259999999997, -112.1675)"
Judith Basin County,Montana,2072,48.3,1645,431,1075,997,"(47.016629999999999, -110.30076)"
Lake County,Montana,28746,41.3,21465,4834,14223,14523,"(47.666600000000003, -114.08428000000001)"
Lewis and Clark County,Montana,63395,40.9,49019,8757,31300,32095,"(47.033279999999998, -112.4842)"
Liberty County,Montana,2339,44.6,1825,462,1125,1214,"(48.549990000000001, -111.01747)"
Lincoln County,Montana,19687,48.9,15791,4040,9998,9689,"(48.549959999999999, -115.38433000000001)"
McCone County,Montana,1734,48.9,1371,382,889,845,"(47.666679999999999, -105.8339)"
Madison County,Montana,7691,49.8,6327,1612,3997,3694,"(45.283259999999999, -111.86748)"
Meagher County,Montana,1891,50.1,1526,428,957,934,"(46.583280000000002, -110.83410000000001)"
Mineral County,Montana,4223,49.8,3465,926,2189,2034,"(47.13326, -114.96763)"
Missoula County,Montana,109299,34.299999999999997,87471,12457,54974,54325,"(47.016590000000001, -113.80092999999999)"
Musselshell County,Montana,4538,49.1,3604,854,2262,2276,"(46.516640000000002, -108.38401)"
Park County,Montana,15636,45.4,12550,2589,7793,7843,"(45.483269999999997, -110.56743)"
Petroleum County,Montana,494,47.3,381,103,267,227,"(47.149990000000003, -108.26734999999999)"
Phillips County,Montana,4253,46.8,3269,863,2097,2156,"(48.2, -107.93401)"
Pondera County,Montana,6153,42.8,4617,1161,2972,3181,"(48.216639999999998, -112.1842)"
Powder River County,Montana,1743,49.3,1380,396,885,858,"(45.383319999999998, -105.65055)"
Powell County,Montana,7027,45.1,5808,1152,4294,2733,"(46.899940000000001, -112.96755)"
Prairie County,Montana,1179,53.6,970,307,601,578,"(46.850009999999997, -105.36721)"
Ravalli County,Montana,40212,46,31388,7728,19964,20248,"(46.133249999999997, -114.13426)"
Richland County,Montana,9746,41.3,7463,1448,5017,4729,"(47.783349999999999, -104.53384)"
Roosevelt County,Montana,10425,31.6,7114,1126,5144,5281,"(48.300020000000004, -105.13387)"
Rosebud County,Montana,9233,36.5,6501,1058,4671,4562,"(46.333329999999997, -106.58392000000001)"
Sanders County,Montana,11413,49.8,9059,2456,5852,5561,"(47.666600000000003, -115.16764999999999)"
Sheridan County,Montana,3384,50.3,2726,782,1698,1686,"(48.71669, -104.40051)"
Silver Bow County,Montana,34200,41.3,27016,5614,17271,16929,"(45.899929999999998, -112.66753)"
Stillwater County,Montana,9117,45.7,7023,1495,4674,4443,"(45.666609999999999, -109.30072)"
Sweet Grass County,Montana,3651,46.6,2811,754,1846,1805,"(45.866610000000001, -109.90074)"
Teton County,Montana,6073,45.8,4659,1261,2995,3078,"(47.799950000000003, -112.26752)"
Toole County,Montana,5324,41.5,4221,739,2966,2358,"(48.649990000000003, -111.63418)"
Treasure County,Montana,718,51.5,584,171,369,349,"(46.233319999999999, -107.28395)"
Valley County,Montana,7369,46.4,5662,1525,3664,3705,"(48.433349999999997, -106.6506)"
Wheatland County,Montana,2168,44.9,1655,448,1069,1099,"(46.449959999999997, -109.83407)"
Wibaux County,Montana,1017,49,800,243,513,504,"(47.016680000000001, -104.18382)"
Yellowstone County,Montana,147972,38.299999999999997,112932,20868,72385,75587,"(45.916620000000002, -108.30068)"
Adams County,Nebraska,31364,37.9,23847,4838,15600,15764,"(40.533349999999999, -98.500900000000001)"
Antelope County,Nebraska,6685,46.6,5111,1404,3329,3356,"(42.166670000000003, -98.067009999999996)"
Arthur County,Nebraska,460,41.4,335,94,228,232,"(41.566650000000003, -101.70045)"
Banner County,Nebraska,690,48.1,536,136,354,336,"(41.549970000000002, -103.71717)"
Blaine County,Nebraska,478,46.1,361,95,247,231,"(41.916670000000003, -99.967070000000007)"
Boone County,Nebraska,5505,45.5,4201,1164,2749,2756,"(41.700009999999999, -98.083669999999998)"
Box Butte County,Nebraska,11308,41.3,8459,1713,5541,5767,"(42.2333, -103.08381)"
Boyd County,Nebraska,2099,50.2,1648,557,1038,1061,"(42.9, -98.783699999999996)"
Brown County,Nebraska,3145,47.9,2464,757,1531,1614,"(42.433329999999998, -99.950400000000002)"
Buffalo County,Nebraska,46102,32.1,35033,5578,22838,23264,"(40.850009999999997, -99.083699999999993)"
Burt County,Nebraska,6858,47.1,5314,1585,3361,3497,"(41.849989999999998, -96.350300000000004)"
Butler County,Nebraska,8395,44.3,6315,1603,4211,4184,"(41.233350000000002, -97.133650000000003)"
Cass County,Nebraska,25241,41.1,18848,3603,12664,12577,"(40.916670000000003, -96.133619999999993)"
Cedar County,Nebraska,8852,44.4,6602,1804,4500,4352,"(42.6, -97.266999999999996)"
Chase County,Nebraska,3966,43.6,3022,810,1965,2001,"(40.533329999999999, -101.70045)"
Cherry County,Nebraska,5713,45.4,4448,1190,2844,2869,"(42.55, -101.10043)"
Cheyenne County,Nebraska,9998,40.4,7604,1592,4966,5032,"(41.216650000000001, -103.00104)"
Clay County,Nebraska,6542,43.2,4892,1168,3277,3265,"(40.533340000000003, -98.050330000000002)"
Colfax County,Nebraska,10515,34.200000000000003,7452,1428,5426,5089,"(41.566670000000002, -97.083650000000006)"
Cuming County,Nebraska,9139,43.7,6857,1901,4532,4607,"(41.916670000000003, -96.783649999999994)"
Custer County,Nebraska,10939,45.4,8353,2283,5427,5512,"(41.4, -99.88373)"
Dakota County,Nebraska,21006,32.799999999999997,14688,2391,10489,10517,"(42.4, -96.566980000000001)"
Dawes County,Nebraska,9182,33,7416,1500,4559,4623,"(42.716639999999998, -103.13379999999999)"
Dawson County,Nebraska,24326,36.200000000000003,17377,3373,12293,12033,"(40.866669999999999, -99.817059999999998)"
Deuel County,Nebraska,1941,48.3,1533,460,954,987,"(41.116660000000003, -102.3338)"
Dixon County,Nebraska,6000,42.1,4463,1070,2964,3036,"(42.516660000000002, -96.816980000000001)"
Dodge County,Nebraska,36691,40.299999999999997,27923,6740,17963,18728,"(41.566670000000002, -96.63364)"
Douglas County,Nebraska,517110,33.5,382391,54875,254164,262946,"(41.3, -96.166970000000006)"
Dundy County,Nebraska,2008,47.9,1562,461,1006,1002,"(40.16666, -101.66712)"
Fillmore County,Nebraska,5890,46.3,4486,1316,2893,2997,"(40.533340000000003, -97.60033)"
Franklin County,Nebraska,3225,48.4,2529,772,1613,1612,"(40.166679999999999, -98.950360000000003)"
Frontier County,Nebraska,2756,43.1,2162,523,1399,1357,"(40.55001, -100.40042)"
Furnas County,Nebraska,4959,47.4,3803,1127,2423,2536,"(40.166670000000003, -99.917069999999995)"
Gage County,Nebraska,22311,43.7,17186,4326,10952,11359,"(40.266669999999998, -96.683639999999997)"
Garden County,Nebraska,2057,49.8,1675,560,1043,1014,"(41.633310000000002, -102.31713999999999)"
Garfield County,Nebraska,2049,50.3,1618,555,1003,1046,"(41.916670000000003, -98.983710000000002)"
Gosper County,Nebraska,2044,47.1,1586,431,1024,1020,"(40.533340000000003, -99.833730000000003)"
Grant County,Nebraska,614,48.2,499,119,336,278,"(41.94999, -101.75100999999999)"
Greeley County,Nebraska,2538,46.4,1941,585,1280,1258,"(41.566679999999998, -98.533690000000007)"
Hall County,Nebraska,58607,35.799999999999997,42630,7850,29287,29320,"(40.866680000000002, -98.500900000000001)"
Hamilton County,Nebraska,9124,42.3,6785,1499,4564,4560,"(40.866680000000002, -97.983670000000004)"
Harlan County,Nebraska,3423,49.2,2686,805,1723,1700,"(40.166679999999999, -99.400379999999998)"
Hayes County,Nebraska,967,47.7,744,191,510,457,"(40.533340000000003, -101.05043000000001)"
Hitchcock County,Nebraska,2908,48.2,2287,665,1446,1462,"(40.16666, -101.05043999999999)"
Holt County,Nebraska,10435,46.1,7986,2143,5189,5246,"(42.45, -98.767039999999994)"
Hooker County,Nebraska,736,50.1,579,193,346,390,"(41.91666, -101.15044)"
Howard County,Nebraska,6274,43.3,4731,1175,3191,3083,"(41.216679999999997, -98.517020000000002)"
Jefferson County,Nebraska,7547,46.8,5939,1661,3717,3830,"(40.166670000000003, -97.150310000000005)"
Johnson County,Nebraska,5217,43.3,4230,919,3015,2202,"(40.4, -96.266959999999997)"
Kearney County,Nebraska,6489,43.3,4917,1187,3187,3302,"(40.500570000000003, -98.950360000000003)"
Keith County,Nebraska,8368,47.3,6563,1772,4196,4172,"(41.19999, -101.65045000000001)"
Keya Paha County,Nebraska,824,50.7,645,211,415,409,"(42.816049999999997, -99.688569999999999)"
Kimball County,Nebraska,3821,46,2964,844,1903,1918,"(41.199979999999996, -103.71716000000001)"
Knox County,Nebraska,8701,46.6,6605,1979,4262,4439,"(42.633339999999997, -97.883679999999998)"
Lancaster County,Nebraska,285407,32.6,219506,31101,143048,142359,"(40.783329999999999, -96.683629999999994)"
Lincoln County,Nebraska,36288,39.200000000000003,27203,5648,17941,18347,"(41.05, -100.76709)"
Logan County,Nebraska,763,43.3,571,139,381,382,"(41.566659999999999, -100.48375)"
Loup County,Nebraska,632,48.5,491,137,324,308,"(41.916670000000003, -99.467060000000004)"
McPherson County,Nebraska,539,43.6,388,97,277,262,"(41.566659999999999, -101.0671)"
Madison County,Nebraska,34876,37.1,26149,5124,17314,17562,"(41.916670000000003, -97.60033)"
Merrick County,Nebraska,7845,42.5,5900,1416,3880,3965,"(41.150010000000002, -98.083669999999998)"
Morrill County,Nebraska,5042,43.4,3832,981,2517,2525,"(41.716639999999998, -103.01715)"
Nance County,Nebraska,3735,45,2859,712,1873,1862,"(41.400010000000002, -98.000889999999998)"
Nemaha County,Nebraska,7248,41,5682,1303,3541,3707,"(40.4, -95.850279999999998)"
Nuckolls County,Nebraska,4500,49.5,3544,1174,2227,2273,"(40.133339999999997, -98.016990000000007)"
Otoe County,Nebraska,15740,42.9,11950,2971,7714,8026,"(40.633330000000001, -96.133619999999993)"
Pawnee County,Nebraska,2773,49.3,2162,720,1378,1395,"(40.133330000000001, -96.233620000000002)"
Perkins County,Nebraska,2970,43.9,2235,602,1499,1471,"(40.833329999999997, -101.58378)"
Phelps County,Nebraska,9188,42.8,6930,1746,4545,4643,"(40.516680000000001, -99.417050000000003)"
Pierce County,Nebraska,7266,42.2,5381,1304,3669,3597,"(42.266669999999998, -97.600340000000003)"
Platte County,Nebraska,32237,38.200000000000003,23723,4802,16141,16096,"(41.55001, -97.48366)"
Polk County,Nebraska,5406,45.3,4088,1069,2696,2710,"(41.183349999999997, -97.533659999999998)"
Red Willow County,Nebraska,11055,41.8,8517,2072,5483,5572,"(40.166670000000003, -100.48376)"
Richardson County,Nebraska,8363,47.1,6566,1916,4132,4231,"(40.15, -95.700270000000003)"
Rock County,Nebraska,1526,49.9,1217,355,763,763,"(42.433329999999998, -99.433729999999997)"
Saline County,Nebraska,14200,36.4,10729,2075,7137,7063,"(40.533340000000003, -97.150319999999994)"
Sarpy County,Nebraska,158840,32.9,113118,13544,78886,79954,"(41.1, -96.133629999999997)"
Saunders County,Nebraska,20780,41.5,15406,3220,10516,10264,"(41.216670000000001, -96.616969999999995)"
Scotts Bluff County,Nebraska,36970,39,27818,6215,17813,19157,"(41.866630000000001, -103.70050000000001)"
Seward County,Nebraska,16750,38,12788,2545,8527,8223,"(40.866680000000002, -97.150319999999994)"
Sheridan County,Nebraska,5469,46.1,4176,1212,2654,2815,"(42.516640000000002, -102.41714)"
Sherman County,Nebraska,3152,47.8,2445,736,1549,1603,"(41.216679999999997, -98.983699999999999)"
Sioux County,Nebraska,1311,47.8,1018,280,673,638,"(42.466630000000002, -103.76716)"
Stanton County,Nebraska,6129,38.6,4445,865,3031,3098,"(41.916670000000003, -97.18365)"
Thayer County,Nebraska,5228,49.2,4111,1347,2551,2677,"(40.166670000000003, -97.600319999999996)"
Thomas County,Nebraska,647,46.7,499,135,328,319,"(41.933329999999998, -100.55042)"
Thurston County,Nebraska,6940,29.4,4473,825,3446,3494,"(42.16666, -96.516980000000004)"
Valley County,Nebraska,4260,46.9,3319,1006,2109,2151,"(41.566679999999998, -98.983699999999999)"
Washington County,Nebraska,20234,40.799999999999997,15142,2841,10077,10157,"(41.549990000000001, -96.266959999999997)"
Wayne County,Nebraska,9595,29.2,7733,1315,4816,4779,"(42.2, -97.150329999999997)"
Webster County,Nebraska,3812,47.2,2951,902,1821,1991,"(40.166679999999999, -98.500889999999998)"
Wheeler County,Nebraska,818,46.1,617,155,412,406,"(41.916670000000003, -98.533690000000007)"
York County,Nebraska,13665,42.2,10607,2489,6670,6995,"(40.866680000000002, -97.60033)"
Churchill County,Nevada,24877,39,18603,3781,12508,12369,"(39.5002, -118.25124)"
Clark County,Nevada,1951269,35.5,1462651,220445,982193,969076,"(36.000259999999997, -114.87609999999999)"
Douglas County,Nevada,46997,47.4,37512,9479,23481,23516,"(38.875190000000003, -119.62627999999999)"
Elko County,Nevada,48818,33.4,34588,4143,25354,23464,"(41.0002, -115.50117)"
Esmeralda County,Nevada,783,52.9,651,202,434,349,"(37.750210000000003, -117.6262)"
Eureka County,Nevada,1987,42.4,1506,257,1048,939,"(40.0002, -116.12618000000001)"
Humboldt County,Nevada,16528,36.200000000000003,12004,1692,8654,7874,"(41.50018, -118.00126)"
Lander County,Nevada,5775,37.1,4181,681,2928,2847,"(39.8752, -116.8762)"
Lincoln County,Nevada,5345,39.9,3908,968,2877,2468,"(38.000239999999998, -114.87612)"
Lyon County,Nevada,51980,40.9,39052,8215,26178,25802,"(39.0002, -119.12626)"
Mineral County,Nevada,4772,49.2,3898,1076,2350,2422,"(38.5002, -118.37624)"
Nye County,Nevada,43946,48.4,34858,10301,22186,21760,"(38.000210000000003, -116.50117)"
Pershing County,Nevada,6753,41,5431,875,4268,2485,"(40.375190000000003, -118.12625)"
Storey County,Nevada,4010,50.5,3309,738,2044,1966,"(39.375190000000003, -119.50129)"
Washoe County,Nevada,421407,37,322075,50879,212744,208663,"(40.75018, -119.62631)"
White Pine County,Nevada,10030,40.799999999999997,7857,1494,5681,4349,"(39.449939999999998, -114.83419000000001)"
Carson City,Nevada,55274,41.7,43459,9133,28688,26586,"(39.164619999999999, -119.77630000000001)"
Belknap County,New Hampshire,60088,44.7,47607,10057,29480,30608,"(43.516739999999999, -71.432850000000002)"
Carroll County,New Hampshire,47818,48.3,38901,9838,23686,24132,"(43.86674, -71.216179999999994)"
Cheshire County,New Hampshire,77117,40.700000000000003,62005,11342,37601,39516,"(42.933410000000002, -72.266199999999998)"
Coos County,New Hampshire,33055,46.4,26803,6399,16802,16253,"(44.633389999999999, -71.316190000000006)"
Grafton County,New Hampshire,89118,41.2,72734,13811,44071,45047,"(43.950069999999997, -71.799530000000004)"
Hillsborough County,New Hampshire,400721,39.299999999999997,306639,47527,198162,202559,"(42.933419999999998, -71.716189999999997)"
Merrimack County,New Hampshire,146445,41.4,114499,20008,72073,74372,"(43.300080000000001, -71.682850000000002)"
Rockingham County,New Hampshire,295223,42.2,227785,37424,145886,149337,"(42.966749999999998, -71.099500000000006)"
Strafford County,New Hampshire,123143,36.9,97723,14645,60012,63131,"(43.316749999999999, -71.049509999999998)"
Sullivan County,New Hampshire,43742,43.9,34540,7217,21621,22121,"(43.36674, -72.232870000000005)"
Atlantic County,New Jersey,274549,39.9,210661,38902,133175,141374,"(39.46678, -74.666269999999997)"
Bergen County,New Jersey,905116,41.1,700711,137103,435962,469154,"(40.933430000000001, -74.049580000000006)"
Burlington County,New Jersey,448734,40.4,344491,62190,220534,228200,"(39.883450000000003, -74.641270000000006)"
Camden County,New Jersey,513657,37.9,388540,65725,247759,265898,"(39.783450000000002, -74.966279999999998)"
Cape May County,New Jersey,97265,47.1,78916,20977,47287,49978,"(39.150109999999998, -74.782939999999996)"
Cumberland County,New Jersey,156898,36.5,119193,19795,80808,76090,"(39.350110000000001, -75.08296)"
Essex County,New Jersey,783969,36.4,589051,90287,375964,408005,"(40.783430000000003, -74.216260000000005)"
Gloucester County,New Jersey,288288,38.700000000000003,218027,35699,139969,148319,"(39.733449999999998, -75.132949999999994)"
Hudson County,New Jersey,634266,34.200000000000003,503104,66066,313787,320479,"(40.716769999999997, -74.066249999999997)"
Hunterdon County,New Jersey,128349,43.5,98132,16344,64103,64246,"(40.566769999999998, -74.932950000000005)"
Mercer County,New Jersey,366513,37.799999999999997,283531,46347,179033,187480,"(40.38344, -74.882940000000005)"
Middlesex County,New Jersey,809858,37.200000000000003,624401,99462,397485,412373,"(40.433439999999997, -74.399590000000003)"
Monmouth County,New Jersey,630380,41.3,480081,86691,306654,323726,"(40.300109999999997, -74.166250000000005)"
Morris County,New Jersey,492276,41.3,374581,68155,241022,251254,"(40.83343, -74.532929999999993)"
Ocean County,New Jersey,576567,42.6,441648,121104,276302,300265,"(39.900120000000001, -74.216250000000002)"
Passaic County,New Jersey,501226,36.1,376613,60324,243124,258102,"(41.066800000000001, -74.365700000000004)"
Salem County,New Jersey,66083,40.799999999999997,50573,9917,32178,33905,"(39.566780000000001, -75.316299999999998)"
Somerset County,New Jersey,323444,40.200000000000003,242609,40002,157624,165820,"(40.566769999999998, -74.549599999999998)"
Sussex County,New Jersey,149265,41.8,113492,17850,74070,75195,"(41.183430000000001, -74.666269999999997)"
Union County,New Jersey,536499,38,405241,67761,259932,276567,"(40.63344, -74.266260000000003)"
Warren County,New Jersey,108692,41.5,83084,15292,52828,55864,"(40.83343, -74.949619999999996)"
Bernalillo County,New Mexico,662564,35.799999999999997,503434,81014,324460,338104,"(35.050049999999999, -106.66725)"
Catron County,New Mexico,3725,55.8,3135,1041,1947,1778,"(34.522539999999999, -109.04592)"
Chaves County,New Mexico,65645,34.700000000000003,47262,9293,32482,33163,"(33.383429999999997, -104.45052)"
Cibola County,New Mexico,27213,36.6,20379,3486,13769,13444,"(34.860869999999998, -109.0587)"
Colfax County,New Mexico,13750,46.7,10911,2758,7003,6747,"(36.875579999999999, -105.12611)"
Curry County,New Mexico,48376,31.5,34659,5526,24288,24088,"(34.952840000000002, -103.25189)"
De Baca County,New Mexico,2022,47.8,1571,463,992,1030,"(34.258409999999998, -104.37609)"
Doña Ana County,New Mexico,209233,32.4,153375,25881,102569,106664,"(33.000639999999997, -106.37611)"
Eddy County,New Mexico,53829,37.299999999999997,39794,7541,26879,26950,"(32.875660000000003, -104.75108)"
Grant County,New Mexico,29514,45.9,23041,6299,14487,15027,"(32.783410000000003, -108.38394)"
Guadalupe County,New Mexico,4687,40.1,3666,728,2648,2039,"(35.125610000000002, -105.25112)"
Harding County,New Mexico,695,55.9,603,203,367,328,"(36.125590000000003, -104.37609)"
Hidalgo County,New Mexico,4894,40.9,3632,815,2455,2439,"(32.697850000000003, -109.02673)"
Lea County,New Mexico,64727,31.9,45699,6991,33045,31682,"(32.80012, -103.46716000000001)"
Lincoln County,New Mexico,20497,49.4,16609,4505,10068,10429,"(34.250630000000001, -105.25111)"
Los Alamos County,New Mexico,17950,44.3,13602,2686,9029,8921,"(35.877800000000001, -106.29225)"
Luna County,New Mexico,25095,39.5,18450,4907,12474,12621,"(32.590359999999997, -107.97587)"
McKinley County,New Mexico,71492,30.7,49119,6813,34620,36872,"(35.900010000000002, -109.03398)"
Mora County,New Mexico,4881,46,3839,915,2498,2383,"(35.9375, -104.94167)"
Otero County,New Mexico,63797,36.5,47836,9552,32194,31603,"(32.533430000000003, -105.7672)"
Quay County,New Mexico,9041,45.6,7073,1865,4456,4585,"(35.041670000000003, -103.54222)"
Rio Arriba County,New Mexico,40246,39,30333,5659,19890,20356,"(36.533349999999999, -106.70059000000001)"
Roosevelt County,New Mexico,19846,29.7,14576,2363,9989,9857,"(33.966749999999998, -103.45050999999999)"
Sandoval County,New Mexico,131561,37.9,96402,15880,64321,67240,"(35.650030000000001, -106.85059)"
San Juan County,New Mexico,130044,33,92393,14083,64544,65500,"(36.999160000000003, -109.04094000000001)"
San Miguel County,New Mexico,29393,40.700000000000003,22931,4469,14661,14732,"(35.483379999999997, -104.88388)"
Santa Fe County,New Mexico,144170,43,113934,21804,70257,73913,"(35.5167, -105.95058)"
Sierra County,New Mexico,11988,54.5,10060,3674,6027,5961,"(33.11674, -107.30058)"
Socorro County,New Mexico,17866,36.9,13596,2533,9172,8694,"(34.0334, -106.88392)"
Taos County,New Mexico,32937,45.2,26155,5627,16211,16726,"(36.566690000000001, -105.66723)"
Torrance County,New Mexico,16383,41.6,12432,2326,8450,7933,"(34.633400000000002, -105.81723)"
Union County,New Mexico,4549,40.9,3619,813,2593,1956,"(36.450029999999998, -103.46717)"
Valencia County,New Mexico,76569,37.700000000000003,56387,9742,38576,37993,"(34.73339, -106.81725)"
Albany County,New York,304204,38.5,243573,42314,147076,157128,"(42.600079999999998, -73.966239999999999)"
Allegany County,New York,48946,37.799999999999997,38370,7443,24696,24250,"(42.250619999999998, -78.033060000000006)"
Bronx County,New York,1385108,32.799999999999997,1016912,145882,649633,735475,"(40.82732, -73.923569999999998)"
Broome County,New York,200600,40.200000000000003,160041,32844,98373,102227,"(42.250630000000001, -75.832970000000003)"
Cattaraugus County,New York,80317,40.700000000000003,61516,12419,39729,40588,"(42.266730000000003, -78.683090000000007)"
Cayuga County,New York,80026,41.5,62728,12235,40833,39193,"(42.966729999999998, -76.582999999999998)"
Chautauqua County,New York,134905,40.9,105459,22381,66509,68396,"(42.250610000000002, -79.399770000000004)"
Chemung County,New York,88830,40.9,68950,13943,44171,44659,"(42.150069999999999, -76.76634)"
Chenango County,New York,50477,42.9,38998,8403,25136,25341,"(42.466740000000001, -75.58296)"
Clinton County,New York,82128,39.1,66238,10952,42097,40031,"(44.733370000000001, -73.682919999999996)"
Columbia County,New York,63096,45.3,50289,11463,31761,31335,"(42.250639999999997, -73.649559999999994)"
Cortland County,New York,49336,35.799999999999997,38925,6458,24093,25243,"(42.600070000000002, -76.082980000000006)"
Delaware County,New York,47980,45.4,38575,9321,24096,23884,"(42.200090000000003, -74.966269999999994)"
Dutchess County,New York,297488,40.200000000000003,231519,40304,148112,149376,"(41.766759999999998, -73.732910000000004)"
Erie County,New York,919040,40.4,720096,144364,442971,476069,"(42.766730000000003, -78.666420000000002)"
Essex County,New York,39370,44.5,31784,7143,20391,18979,"(44.100050000000003, -73.816249999999997)"
Franklin County,New York,51599,39.299999999999997,40879,6880,28336,23263,"(44.65005, -74.349609999999998)"
Fulton County,New York,55531,41.8,43205,8901,27465,28066,"(43.11674, -74.449579999999997)"
Genesee County,New York,60079,41.5,46820,9390,29756,30323,"(43.000619999999998, -78.183070000000001)"
Greene County,New York,49221,44,39739,8514,25680,23541,"(42.266750000000002, -74.216250000000002)"
Hamilton County,New York,4836,51.3,4041,1130,2446,2390,"(43.666730000000001, -74.500159999999994)"
Herkimer County,New York,64519,42.1,50221,10856,31579,32940,"(43.450069999999997, -74.949600000000004)"
Jefferson County,New York,116229,32.6,86596,12981,59185,57044,"(44.050060000000002, -75.899649999999994)"
Kings County,New York,2504700,34.1,1910322,287633,1181378,1323322,"(40.650100000000002, -73.949579999999997)"
Lewis County,New York,27087,40.200000000000003,20384,4076,13620,13467,"(43.800069999999998, -75.482960000000006)"
Livingston County,New York,65393,39.799999999999997,52176,8985,32816,32577,"(42.733400000000003, -77.766390000000001)"
Madison County,New York,73442,39.5,57437,10239,36064,37378,"(42.933399999999999, -75.649630000000002)"
Monroe County,New York,744344,38.5,575645,103594,359108,385236,"(43.150060000000003, -77.683059999999998)"
Montgomery County,New York,50219,40.799999999999997,38418,8329,24447,25772,"(42.883409999999998, -74.416250000000005)"
Nassau County,New York,1339532,41.1,1027952,204681,647978,691554,"(40.750660000000003, -73.582899999999995)"
New York County,New York,1585873,36.4,1351438,214153,744441,841432,"(40.783430000000003, -73.966250000000002)"
Niagara County,New York,216469,41.9,169979,34388,105008,111461,"(43.166719999999998, -78.766419999999997)"
Oneida County,New York,234878,40.799999999999997,183501,38168,117032,117846,"(43.200069999999997, -75.466290000000001)"
Onondaga County,New York,467026,38.6,359771,65578,224861,242165,"(43.000619999999998, -76.166309999999996)"
Ontario County,New York,107931,42.1,83631,16612,52742,55189,"(42.866729999999997, -77.316370000000006)"
Orange County,New York,372813,36.6,271284,40985,186289,186524,"(41.416759999999996, -74.31626)"
Orleans County,New York,42883,41,33343,6178,21233,21650,"(43.250610000000002, -78.233080000000001)"
Oswego County,New York,122109,38.5,93886,15400,60859,61250,"(43.450069999999997, -76.149649999999994)"
Otsego County,New York,62259,40.9,50641,10281,30115,32144,"(42.633409999999998, -75.016270000000006)"
Putnam County,New York,99710,41.9,76060,12417,49789,49921,"(41.433430000000001, -73.732910000000004)"
Queens County,New York,2230722,37.200000000000003,1768821,286146,1079803,1150919,"(40.700099999999999, -73.799580000000006)"
Rensselaer County,New York,159429,39.200000000000003,125460,21607,78709,80720,"(42.716749999999998, -73.482889999999998)"
Richmond County,New York,468730,38.4,359529,59344,227289,241441,"(40.583440000000003, -74.149590000000003)"
Rockland County,New York,311687,36.700000000000003,224107,41841,152879,158808,"(41.166759999999996, -74.049589999999995)"
St. Lawrence County,New York,111944,37.5,88139,15553,56852,55092,"(44.500619999999998, -75.116309999999999)"
Saratoga County,New York,219607,40.9,169751,29994,108059,111548,"(43.100070000000002, -73.84957)"
Schenectady County,New York,154727,39.799999999999997,119218,23083,74856,79871,"(42.833410000000001, -74.082899999999995)"
Schoharie County,New York,32749,42.5,26217,5220,16375,16374,"(42.566740000000003, -74.466250000000002)"
Schuyler County,New York,18343,44.2,14453,3116,9122,9221,"(42.416739999999997, -76.883009999999999)"
Seneca County,New York,35251,41,27732,5472,18454,16797,"(42.7834, -76.849680000000006)"
Steuben County,New York,98990,41.4,75792,15718,49126,49864,"(42.266739999999999, -77.333039999999997)"
Suffolk County,New York,1493350,39.799999999999997,1135680,201793,734668,758682,"(40.866770000000002, -72.799549999999996)"
Sullivan County,New York,77547,41.7,59971,11455,39614,37933,"(41.700090000000003, -74.782939999999996)"
Tioga County,New York,51125,42.5,39148,8032,25345,25780,"(42.166739999999997, -76.266319999999993)"
Tompkins County,New York,101564,29.8,84905,10929,50031,51533,"(42.450069999999997, -76.466329999999999)"
Ulster County,New York,182493,42,145677,27044,90809,91684,"(41.883429999999997, -74.250150000000005)"
Warren County,New York,65707,44.1,52162,11247,32082,33625,"(43.550069999999998, -73.799570000000003)"
Washington County,New York,63216,41.7,49899,9707,32758,30458,"(43.333410000000001, -73.43289)"
Wayne County,New York,93772,41.6,71473,13363,46520,47252,"(43.150060000000003, -77.033029999999997)"
Westchester County,New York,949113,40,721113,139122,456661,492452,"(41.116759999999999, -73.799580000000006)"
Wyoming County,New York,42155,40.9,33451,5723,22953,19202,"(42.700060000000001, -78.199730000000002)"
Yates County,New York,25348,40.700000000000003,19133,4216,12278,13070,"(42.61674, -77.099689999999995)"
Alamance County,North Carolina,151131,38.700000000000003,115688,22081,71890,79241,"(36.033470000000001, -79.399739999999994)"
Alexander County,North Carolina,37198,40.799999999999997,28745,5627,18824,18374,"(35.93347, -81.183139999999995)"
Alleghany County,North Carolina,11155,45.9,8920,2304,5532,5623,"(36.483460000000001, -81.116470000000007)"
Anson County,North Carolina,26948,39.5,20982,3866,14015,12933,"(34.983490000000003, -80.099779999999996)"
Ashe County,North Carolina,27281,45.5,21980,5501,13489,13792,"(36.433459999999997, -81.499830000000003)"
Avery County,North Carolina,17797,42.3,14738,3097,9690,8107,"(36.10013, -81.933170000000004)"
Beaufort County,North Carolina,47759,43.8,37232,8782,23008,24751,"(35.433500000000002, -76.866330000000005)"
Bertie County,North Carolina,21282,42.9,16846,3656,10534,10748,"(36.06682, -76.966340000000002)"
Bladen County,North Carolina,35190,41.3,27073,5481,16887,18303,"(34.633499999999998, -78.566400000000002)"
Brunswick County,North Carolina,107431,47.4,87270,23026,52660,54771,"(34.066839999999999, -78.266390000000001)"
Buncombe County,North Carolina,238318,40.6,189478,38096,114770,123548,"(35.600110000000001, -82.516509999999997)"
Burke County,North Carolina,90912,41.2,70724,14673,45468,45444,"(35.766800000000003, -81.699820000000003)"
Cabarrus County,North Carolina,178011,36.700000000000003,129230,20085,86944,91067,"(35.366810000000001, -80.566460000000006)"
Caldwell County,North Carolina,83029,41.3,64243,12816,40848,42181,"(35.950130000000001, -81.549819999999997)"
Camden County,North Carolina,9980,40.1,7423,1283,5006,4974,"(36.366819999999997, -76.182990000000004)"
Carteret County,North Carolina,66469,45.8,53894,12659,32829,33640,"(34.800159999999998, -76.699650000000005)"
Caswell County,North Carolina,23719,43.6,18830,3755,12074,11645,"(36.40014, -79.349739999999997)"
Catawba County,North Carolina,154358,39.6,117563,21773,75603,78755,"(35.666800000000002, -81.233140000000006)"
Chatham County,North Carolina,63505,43.6,49664,11631,30654,32851,"(35.700139999999998, -79.266409999999993)"
Cherokee County,North Carolina,27444,48.1,22157,6284,13341,14103,"(35.150080000000003, -84.033240000000006)"
Chowan County,North Carolina,14793,44.8,11476,2908,7030,7763,"(36.15016, -76.64967)"
Clay County,North Carolina,10587,49.6,8604,2498,5223,5364,"(35.050089999999997, -83.766559999999998)"
Cleveland County,North Carolina,98078,40.299999999999997,75080,14677,47319,50759,"(35.333460000000002, -81.549809999999994)"
Columbus County,North Carolina,58098,39.799999999999997,44566,8830,28753,29345,"(34.250450000000001, -78.633070000000004)"
Craven County,North Carolina,103505,36.200000000000003,79302,15810,51492,52013,"(35.133490000000002, -77.066339999999997)"
Cumberland County,North Carolina,319431,31,233890,30200,154328,165103,"(35.050159999999998, -78.866410000000002)"
Currituck County,North Carolina,23547,41.3,17956,3041,11669,11878,"(36.312660000000001, -75.937139999999999)"
Dare County,North Carolina,33920,43.6,27128,5167,16956,16964,"(35.750450000000001, -75.766289999999998)"
Davidson County,North Carolina,162878,40.299999999999997,124006,23388,79797,83081,"(35.816800000000001, -80.233109999999996)"
Davie County,North Carolina,41240,42.5,31489,6829,20136,21104,"(35.93347, -80.533109999999994)"
Duplin County,North Carolina,58505,37.799999999999997,43635,8295,28758,29747,"(34.95017, -77.949709999999996)"
Durham County,North Carolina,267587,33.200000000000003,207266,26117,127656,139931,"(36.033479999999997, -78.866399999999999)"
Edgecombe County,North Carolina,56552,39.6,42673,8104,26239,30313,"(35.90016, -77.583029999999994)"
Forsyth County,North Carolina,350670,37.200000000000003,265269,45511,166419,184251,"(36.133470000000003, -80.233099999999993)"
Franklin County,North Carolina,60619,39.1,45757,7678,30166,30453,"(36.06682, -78.33305)"
Gaston County,North Carolina,206086,38.9,156845,27294,99718,106368,"(35.300139999999999, -81.199799999999996)"
Gates County,North Carolina,12197,42,9294,1831,5962,6235,"(36.433489999999999, -76.699680000000001)"
Graham County,North Carolina,8861,44.3,6948,1742,4367,4494,"(35.350090000000002, -83.799899999999994)"
Granville County,North Carolina,59916,39.799999999999997,46583,7441,32015,27901,"(36.316809999999997, -78.649720000000002)"
Greene County,North Carolina,21362,37.700000000000003,16410,2665,11457,9905,"(35.500720000000001, -77.666359999999997)"
Guilford County,North Carolina,488406,36.299999999999997,373923,60123,232483,255923,"(36.066800000000001, -79.799750000000003)"
Halifax County,North Carolina,54691,41.7,42073,8836,26137,28554,"(36.250149999999998, -77.649699999999996)"
Harnett County,North Carolina,114678,33.5,82851,11947,56199,58479,"(35.383490000000002, -78.849739999999997)"
Haywood County,North Carolina,59036,45.6,47501,12416,28502,30534,"(35.5501, -82.966530000000006)"
Henderson County,North Carolina,106740,45.4,84781,23865,51560,55180,"(35.350119999999997, -82.46651)"
Hertford County,North Carolina,24669,41,19472,3898,12062,12607,"(36.350149999999999, -76.983019999999996)"
Hoke County,North Carolina,46952,30.9,32767,3483,22878,24074,"(35.016829999999999, -79.266419999999997)"
Hyde County,North Carolina,5810,41.2,4734,875,3226,2584,"(35.500169999999997, -76.266310000000004)"
Iredell County,North Carolina,159437,38.9,118852,20445,78491,80946,"(35.783470000000001, -80.883129999999994)"
Jackson County,North Carolina,40271,36.299999999999997,33148,6084,20043,20228,"(35.266770000000001, -83.133200000000002)"
Johnston County,North Carolina,168878,36.299999999999997,121908,17259,83150,85728,"(35.53349, -78.399720000000002)"
Jones County,North Carolina,10153,44.1,7945,1756,4883,5270,"(35.016829999999999, -77.399680000000004)"
Lee County,North Carolina,57866,37.4,43006,7937,28264,29602,"(35.466819999999998, -79.183080000000004)"
Lenoir County,North Carolina,59495,41,45163,9514,28397,31098,"(35.233499999999999, -77.649690000000007)"
Lincoln County,North Carolina,78265,40.4,59784,10361,38813,39452,"(35.483469999999997, -81.249799999999993)"
McDowell County,North Carolina,44996,41.6,35211,7377,22517,22479,"(35.700119999999998, -82.04983)"
Macon County,North Carolina,33922,47.8,27388,8069,16495,17427,"(35.150089999999999, -83.449879999999993)"
Madison County,North Carolina,20764,43.3,16672,3666,10273,10491,"(35.866770000000002, -82.666529999999995)"
Martin County,North Carolina,24505,44,19070,4297,11433,13072,"(35.833489999999998, -77.149680000000004)"
Mecklenburg County,North Carolina,919628,33.9,686290,81113,444881,474747,"(35.26681, -80.849789999999999)"
Mitchell County,North Carolina,15579,45.7,12544,3260,7600,7979,"(36.01679, -82.133179999999996)"
Montgomery County,North Carolina,27798,40.200000000000003,21052,4364,13458,14340,"(35.350140000000003, -79.899770000000004)"
Moore County,North Carolina,88247,45,69098,19986,42176,46071,"(35.300150000000002, -79.483080000000001)"
Nash County,North Carolina,95840,39.9,72905,13393,46275,49565,"(35.966819999999998, -77.966369999999998)"
New Hanover County,North Carolina,202667,37.299999999999997,162254,28092,98269,104398,"(34.250450000000001, -77.866370000000003)"
Northampton County,North Carolina,22099,45.5,17499,4336,10714,11385,"(36.416820000000001, -77.36636)"
Onslow County,North Carolina,177772,25.7,132834,13262,95349,82423,"(34.750439999999998, -77.433019999999999)"
Orange County,North Carolina,133801,33.1,105832,12889,63954,69847,"(36.066809999999997, -79.116399999999999)"
Pamlico County,North Carolina,13144,48.3,10790,2857,6710,6434,"(35.133499999999998, -76.749650000000003)"
Pasquotank County,North Carolina,40661,36.6,31462,5513,19969,20692,"(36.300159999999998, -76.282989999999998)"
Pender County,North Carolina,52217,41.1,40328,7886,26134,26083,"(34.500439999999998, -77.966380000000001)"
Perquimans County,North Carolina,13453,46.4,10684,2887,6446,7007,"(36.216819999999998, -76.449659999999994)"
Person County,North Carolina,39464,41.4,30350,5993,19137,20327,"(36.383470000000003, -78.966399999999993)"
Pitt County,North Carolina,168148,31,130350,16619,79360,88788,"(35.583489999999998, -77.383020000000002)"
Polk County,North Carolina,20510,49.1,16572,4993,9825,10685,"(35.283450000000002, -82.166499999999999)"
Randolph County,North Carolina,141752,39.5,107038,19949,69838,71914,"(35.700139999999998, -79.816419999999994)"
Richmond County,North Carolina,46639,38.700000000000003,35259,6691,22957,23682,"(35.002929999999999, -79.752549999999999)"
Robeson County,North Carolina,134168,34.4,98241,15078,65243,68925,"(34.633499999999998, -79.099760000000003)"
Rockingham County,North Carolina,93643,42.2,72854,15171,45166,48477,"(36.40014, -79.783090000000001)"
Rowan County,North Carolina,138428,39.1,105486,19993,68363,70065,"(35.65014, -80.516450000000006)"
Rutherford County,North Carolina,67810,42.5,52586,11726,32781,35029,"(35.400120000000001, -81.916489999999996)"
Sampson County,North Carolina,63431,38.200000000000003,47154,9044,31108,32323,"(34.966839999999998, -78.399720000000002)"
Scotland County,North Carolina,36157,38.4,27084,4914,17466,18691,"(34.833489999999998, -79.499769999999998)"
Stanly County,North Carolina,60585,40.5,46852,9507,30111,30474,"(35.333480000000002, -80.249780000000001)"
Stokes County,North Carolina,47401,42.8,36880,7575,23124,24277,"(36.40014, -80.249769999999998)"
Surry County,North Carolina,73673,41.2,56456,12250,35971,37702,"(36.400129999999997, -80.683120000000002)"
Swain County,North Carolina,13981,40.799999999999997,10712,2321,6812,7169,"(35.466760000000001, -83.483220000000003)"
Transylvania County,North Carolina,33090,48.8,27258,8539,15973,17117,"(35.21678, -82.783180000000002)"
Tyrrell County,North Carolina,4407,41.4,3612,742,2434,1973,"(35.816830000000003, -76.216309999999993)"
Union County,North Carolina,201292,36.200000000000003,140412,19466,99366,101926,"(35.000149999999998, -80.549790000000002)"
Vance County,North Carolina,45422,38.6,33881,6421,21319,24103,"(36.366810000000001, -78.399720000000002)"
Wake County,North Carolina,900993,34.4,666380,76549,438792,462201,"(35.783479999999997, -78.63306)"
Warren County,North Carolina,20972,44.9,16714,3961,10597,10375,"(36.383479999999999, -78.099710000000002)"
Washington County,North Carolina,13228,44,10185,2414,6221,7007,"(35.833500000000001, -76.59966)"
Watauga County,North Carolina,51079,28.4,44005,6329,25636,25443,"(36.233460000000001, -81.699830000000006)"
Wayne County,North Carolina,122623,36.6,92139,16078,59956,62667,"(35.36683, -77.999989999999997)"
Wilkes County,North Carolina,69340,42.4,53804,11778,34264,35076,"(36.216799999999999, -80.999799999999993)"
Wilson County,North Carolina,81234,38.700000000000003,61182,11517,38784,42450,"(35.716819999999998, -77.916370000000001)"
Yadkin County,North Carolina,38406,41.4,29468,6241,18877,19529,"(36.15014, -80.666449999999998)"
Yancey County,North Carolina,17818,45.5,14256,3672,8744,9074,"(35.900109999999998, -82.299850000000006)"
Adams County,North Dakota,2343,49.5,1897,568,1131,1212,"(46.05556, -102.52544)"
Barnes County,North Dakota,11066,44.3,8786,2170,5490,5576,"(46.94444, -98.058610000000002)"
Benson County,North Dakota,6660,31.6,4421,853,3379,3281,"(48.041670000000003, -99.450410000000005)"
Billings County,North Dakota,783,48.6,645,151,417,366,"(47.069459999999999, -103.33378999999999)"
Bottineau County,North Dakota,6429,48,5207,1382,3321,3108,"(48.808349999999997, -100.80598000000001)"
Bowman County,North Dakota,3151,46.9,2475,692,1580,1571,"(46.069450000000003, -103.52547)"
Burke County,North Dakota,1968,48.1,1559,412,1035,933,"(48.7667, -102.53377999999999)"
Burleigh County,North Dakota,81308,37.299999999999997,62965,10913,39992,41316,"(46.958329999999997, -100.4615)"
Cass County,North Dakota,149778,31.5,117118,14550,75551,74227,"(46.94164, -97.225369999999998)"
Cavalier County,North Dakota,3993,50.3,3207,1022,2043,1950,"(48.769449999999999, -98.475399999999993)"
Dickey County,North Dakota,5289,43,4074,1170,2626,2663,"(46.10275, -98.500380000000007)"
Divide County,North Dakota,2071,51.4,1717,551,1061,1010,"(48.813920000000003, -103.49214000000001)"
Dunn County,North Dakota,3536,44.4,2759,616,1865,1671,"(47.366680000000002, -102.55046)"
Eddy County,North Dakota,2385,49.2,1887,586,1166,1219,"(47.708329999999997, -98.894829999999999)"
Emmons County,North Dakota,3550,50.5,2791,971,1820,1730,"(46.316659999999999, -100.21706)"
Foster County,North Dakota,3343,46.7,2615,758,1675,1668,"(47.45, -98.875380000000007)"
Golden Valley County,North Dakota,1680,45.9,1276,358,831,849,"(46.938899999999997, -103.85048)"
Grand Forks County,North Dakota,66861,29.7,53440,6903,34355,32506,"(47.941650000000003, -97.433700000000002)"
Grant County,North Dakota,2394,51.7,1944,645,1189,1205,"(46.352780000000003, -101.63652999999999)"
Griggs County,North Dakota,2420,51.9,1961,637,1225,1195,"(47.433329999999998, -98.219819999999999)"
Hettinger County,North Dakota,2477,49.4,2009,638,1178,1299,"(46.436109999999999, -102.43378)"
Kidder County,North Dakota,2435,47.2,1912,511,1242,1193,"(46.958320000000001, -99.750380000000007)"
LaMoure County,North Dakota,4139,49.2,3266,1022,2118,2021,"(46.447200000000002, -98.567040000000006)"
Logan County,North Dakota,1990,49.8,1570,557,1012,978,"(46.461089999999999, -99.447609999999997)"
McHenry County,North Dakota,5395,46.2,4216,1118,2793,2602,"(48.25, -100.62542000000001)"
McIntosh County,North Dakota,2809,52.7,2296,954,1373,1436,"(46.108310000000003, -99.425389999999993)"
McKenzie County,North Dakota,6360,38,4669,902,3282,3078,"(47.708350000000003, -103.44768999999999)"
McLean County,North Dakota,8962,49.1,7195,1941,4557,4405,"(47.641669999999998, -101.30043999999999)"
Mercer County,North Dakota,8424,46.3,6625,1328,4344,4080,"(47.350009999999997, -101.86156)"
Morton County,North Dakota,27471,39.299999999999997,20910,4013,13698,13773,"(46.772219999999997, -101.26152999999999)"
Mountrail County,North Dakota,7673,37,5843,1050,4185,3488,"(48.219459999999998, -102.33101000000001)"
Nelson County,North Dakota,3126,51.5,2566,858,1593,1533,"(47.941659999999999, -98.183710000000005)"
Oliver County,North Dakota,1846,47.6,1436,308,965,881,"(47.105550000000001, -101.3032)"
Pembina County,North Dakota,7413,46.7,5813,1489,3777,3636,"(48.766660000000002, -97.517030000000005)"
Pierce County,North Dakota,4357,46.9,3419,1029,2179,2178,"(48.274999999999999, -100.03652)"
Ramsey County,North Dakota,11451,43,8936,2072,5694,5757,"(48.233339999999998, -98.733729999999994)"
Ransom County,North Dakota,5457,45.2,4176,1084,2771,2686,"(46.474969999999999, -97.636489999999995)"
Renville County,North Dakota,2470,45.4,1936,502,1269,1201,"(48.727800000000002, -101.67543999999999)"
Richland County,North Dakota,16321,39.4,12659,2424,8438,7883,"(46.288849999999996, -96.917029999999997)"
Rolette County,North Dakota,13937,30.5,9277,1398,6897,7040,"(48.783340000000003, -99.814310000000006)"
Sargent County,North Dakota,3829,45.9,2957,727,2043,1786,"(46.099960000000003, -97.625370000000004)"
Sheridan County,North Dakota,1321,53.4,1110,396,662,659,"(47.566659999999999, -100.31707)"
Sioux County,North Dakota,4153,26.3,2637,294,2129,2024,"(46.1, -100.90040999999999)"
Slope County,North Dakota,727,49.2,581,135,396,331,"(46.3889, -103.38657000000001)"
Stark County,North Dakota,24199,38.299999999999997,19013,3875,12094,12105,"(46.811120000000003, -102.69212)"
Steele County,North Dakota,1975,47.7,1554,441,1009,966,"(47.436100000000003, -97.717039999999997)"
Stutsman County,North Dakota,21100,42,16769,3618,10733,10367,"(46.958329999999997, -98.933610000000002)"
Towner County,North Dakota,2246,50.3,1814,552,1143,1103,"(48.683340000000001, -99.200419999999994)"
Traill County,North Dakota,8121,42.6,6311,1521,4067,4054,"(47.444429999999997, -97.167029999999997)"
Walsh County,North Dakota,11119,45.9,8652,2237,5608,5511,"(48.366660000000003, -97.692030000000003)"
Ward County,North Dakota,61675,32.700000000000003,47173,8026,31250,30425,"(48.216679999999997, -101.45878)"
Wells County,North Dakota,4207,51.5,3443,1221,2065,2142,"(47.59722, -99.650400000000005)"
Williams County,North Dakota,22398,39,17233,3328,11548,10850,"(48.302799999999998, -103.43380000000001)"
Adams County,Ohio,28550,39.6,21415,4230,14095,14455,"(38.850070000000002, -83.466579999999993)"
Allen County,Ohio,106331,38.299999999999997,80886,15697,53630,52701,"(40.766719999999999, -84.083280000000002)"
Ashland County,Ohio,53139,39.299999999999997,40463,8416,25972,27167,"(40.816719999999997, -82.266549999999995)"
Ashtabula County,Ohio,101497,41,77490,15877,50693,50804,"(41.700060000000001, -80.766469999999998)"
Athens County,Ohio,64757,26.3,54508,6538,32427,32330,"(39.350070000000002, -82.049869999999999)"
Auglaize County,Ohio,45949,40,34283,7061,22787,23162,"(40.550049999999999, -84.250230000000002)"
Belmont County,Ohio,70400,43.4,56545,12419,35492,34908,"(40.000349999999997, -80.966480000000004)"
Brown County,Ohio,44846,39.9,33808,6469,22253,22593,"(38.933399999999999, -83.866590000000002)"
Butler County,Ohio,368130,36,275526,42484,180140,187990,"(39.450060000000001, -84.566609999999997)"
Carroll County,Ohio,28836,43.1,22199,4803,14396,14440,"(40.56673, -81.083150000000003)"
Champaign County,Ohio,40097,39.700000000000003,30057,5758,19844,20253,"(40.133389999999999, -83.766599999999997)"
Clark County,Ohio,138333,40.5,105690,22422,66989,71344,"(39.916730000000001, -83.766589999999994)"
Clermont County,Ohio,197363,38.5,146773,23244,97326,100037,"(39.050060000000002, -84.149929999999998)"
Clinton County,Ohio,42040,38.700000000000003,31778,5684,20609,21431,"(39.400060000000003, -83.816590000000005)"
Columbiana County,Ohio,107841,42.3,84257,17793,54185,53656,"(40.750340000000001, -80.750079999999997)"
Coshocton County,Ohio,36901,40.799999999999997,28022,5992,18225,18676,"(40.300069999999998, -81.916520000000006)"
Crawford County,Ohio,43784,41.9,33651,7796,21260,22524,"(40.850059999999999, -82.916569999999993)"
Cuyahoga County,Ohio,1280122,40.200000000000003,989860,198541,607362,672760,"(41.433390000000003, -81.666520000000006)"
Darke County,Ohio,52959,40.799999999999997,39746,8929,26028,26931,"(40.133380000000002, -84.616619999999998)"
Defiance County,Ohio,39037,39.4,29434,5857,19225,19812,"(41.333379999999998, -84.449950000000001)"
Delaware County,Ohio,174214,37.4,123710,16517,85925,88289,"(40.266730000000003, -83.00018)"
Erie County,Ohio,77079,43.4,59934,13305,37782,39297,"(41.350050000000003, -82.599900000000005)"
Fairfield County,Ohio,146156,38.200000000000003,107747,18075,72450,73706,"(39.750340000000001, -82.599890000000002)"
Fayette County,Ohio,29030,39.4,21867,4345,14271,14759,"(39.550060000000002, -83.449920000000006)"
Franklin County,Ohio,1163414,33.4,884872,115706,566499,596915,"(39.966729999999998, -83.016570000000002)"
Fulton County,Ohio,42698,39.9,31689,6000,20984,21714,"(41.600050000000003, -84.133279999999999)"
Gallia County,Ohio,30934,39.9,23582,4940,15237,15697,"(38.816749999999999, -82.333209999999994)"
Geauga County,Ohio,93389,43.3,69152,14474,45902,47487,"(41.500610000000002, -81.166489999999996)"
Greene County,Ohio,161573,37.200000000000003,126440,21998,79100,82473,"(39.683390000000003, -83.899929999999998)"
Guernsey County,Ohio,40087,40.9,30472,6426,19644,20443,"(40.050069999999998, -81.516509999999997)"
Hamilton County,Ohio,802374,37.1,612734,106863,385221,417153,"(39.183390000000003, -84.533280000000005)"
Hancock County,Ohio,74782,38.5,57154,10673,36284,38498,"(41.016719999999999, -83.666600000000003)"
Hardin County,Ohio,32058,34.700000000000003,24498,4303,15907,16151,"(40.65005, -83.666600000000003)"
Harrison County,Ohio,15864,44.4,12392,2880,7870,7994,"(40.2834, -81.066490000000002)"
Henry County,Ohio,28215,39.799999999999997,21121,4349,13974,14241,"(41.350050000000003, -84.099950000000007)"
Highland County,Ohio,43589,39.200000000000003,32497,6618,21348,22241,"(39.183399999999999, -83.616590000000002)"
Hocking County,Ohio,29380,40.9,22375,4491,14685,14695,"(39.516730000000003, -82.466539999999995)"
Holmes County,Ohio,42366,29.7,27855,4801,21125,21241,"(40.550060000000002, -81.899860000000004)"
Huron County,Ohio,59626,38.4,43959,8084,29371,30255,"(41.15005, -82.549899999999994)"
Jackson County,Ohio,33225,39,25070,4690,16239,16986,"(39.033410000000003, -82.616550000000004)"
Jefferson County,Ohio,69709,43.9,55655,12756,33455,36254,"(40.366729999999997, -80.750079999999997)"
Knox County,Ohio,60921,38.299999999999997,46220,8987,29751,31170,"(40.400060000000003, -82.372100000000003)"
Lake County,Ohio,230041,42.3,179015,36965,112143,117898,"(41.633380000000002, -81.383170000000007)"
Lawrence County,Ohio,62450,40.1,47801,9717,30361,32089,"(38.583410000000001, -82.549880000000002)"
Licking County,Ohio,166492,39.1,125367,22087,81524,84968,"(40.083399999999997, -82.500159999999994)"
Logan County,Ohio,45858,39.9,34239,6760,22600,23258,"(40.366720000000001, -83.766599999999997)"
Lorain County,Ohio,301356,40,229278,43131,148135,153221,"(41.333379999999998, -82.149870000000007)"
Lucas County,Ohio,441815,37,335678,57809,213966,227849,"(41.65005, -83.666600000000003)"
Madison County,Ohio,43435,39.1,33628,5389,23732,19703,"(39.866729999999997, -83.433250000000001)"
Mahoning County,Ohio,238823,42.9,187485,42702,115500,123323,"(41.033389999999997, -80.766469999999998)"
Marion County,Ohio,66501,39.9,51772,9468,34875,31626,"(40.583390000000001, -83.166579999999996)"
Medina County,Ohio,172332,40.4,128591,22601,84941,87391,"(41.100050000000003, -81.883189999999999)"
Meigs County,Ohio,23770,41.2,18356,3725,11661,12109,"(39.100079999999998, -82.016530000000003)"
Mercer County,Ohio,40814,39.4,30041,6304,20419,20395,"(40.550049999999999, -84.633290000000002)"
Miami County,Ohio,102506,40.6,77738,15731,50386,52120,"(40.050049999999999, -84.233279999999993)"
Monroe County,Ohio,14642,44.7,11495,2838,7289,7353,"(39.733409999999999, -81.066490000000002)"
Montgomery County,Ohio,535153,39.200000000000003,411874,81041,256961,278192,"(39.750340000000001, -84.299940000000007)"
Morgan County,Ohio,15054,42.4,11534,2611,7500,7554,"(39.61674, -81.833190000000002)"
Morrow County,Ohio,34827,39.5,25834,4680,17454,17373,"(40.533389999999997, -82.783230000000003)"
Muskingum County,Ohio,86074,39.5,65423,13184,41637,44437,"(39.950069999999997, -81.949860000000001)"
Noble County,Ohio,14645,48.6,11848,3042,8472,6173,"(39.833410000000001, -81.46651)"
Ottawa County,Ohio,41428,46.3,32833,7868,20437,20991,"(41.533380000000001, -83.099919999999997)"
Paulding County,Ohio,19614,40,14676,2907,9703,9911,"(41.116720000000001, -84.583290000000005)"
Perry County,Ohio,36058,38.6,26627,4658,17975,18083,"(39.733400000000003, -82.233199999999997)"
Pickaway County,Ohio,55698,38.5,42541,7156,29231,26467,"(39.650060000000003, -83.033240000000006)"
Pike County,Ohio,28709,39.200000000000003,21589,4212,14254,14455,"(39.066740000000003, -83.066569999999999)"
Portage County,Ohio,161419,37.4,127741,20819,78841,82578,"(41.166719999999998, -81.199820000000003)"
Preble County,Ohio,42270,40.9,32032,6428,20968,21302,"(39.750329999999998, -84.633290000000002)"
Putnam County,Ohio,34499,39,25299,4930,17242,17257,"(41.033380000000001, -84.133279999999999)"
Richland County,Ohio,124475,40.9,96456,20260,62927,61548,"(40.783389999999997, -82.549890000000005)"
Ross County,Ohio,78064,39.799999999999997,60479,10520,41167,36897,"(39.350059999999999, -83.066569999999999)"
Sandusky County,Ohio,60944,40.4,46076,9315,29992,30952,"(41.350050000000003, -83.133250000000004)"
Scioto County,Ohio,79499,38.799999999999997,61409,12317,39258,40241,"(38.800080000000001, -82.983230000000006)"
Seneca County,Ohio,56745,38.799999999999997,43377,8425,28337,28408,"(41.116720000000001, -83.116579999999999)"
Shelby County,Ohio,49423,37.9,35921,6362,24649,24774,"(40.316719999999997, -84.183279999999996)"
Stark County,Ohio,375586,41.1,289600,60978,181742,193844,"(40.816719999999997, -81.366500000000002)"
Summit County,Ohio,541781,40,418206,78968,262012,279769,"(41.116720000000001, -81.533169999999998)"
Trumbull County,Ohio,210312,42.8,163680,36617,102150,108162,"(41.316719999999997, -80.766469999999998)"
Tuscarawas County,Ohio,92582,40.9,70618,15172,45491,47091,"(40.450069999999997, -81.466499999999996)"
Union County,Ohio,52300,36.4,38050,4943,24701,27599,"(40.300060000000002, -83.383260000000007)"
Van Wert County,Ohio,28744,40.299999999999997,21580,4688,14001,14743,"(40.866720000000001, -84.583290000000005)"
Vinton County,Ohio,13435,39.6,10100,1879,6688,6747,"(39.250630000000001, -82.466539999999995)"
Warren County,Ohio,212693,37.799999999999997,154218,22936,106896,105797,"(39.433390000000003, -84.166600000000003)"
Washington County,Ohio,61778,43,48837,10794,30165,31613,"(39.501460000000002, -81.416510000000002)"
Wayne County,Ohio,114520,38.299999999999997,85375,16687,56599,57921,"(40.833390000000001, -81.883200000000002)"
Williams County,Ohio,37642,40.700000000000003,28723,6031,18679,18963,"(41.550049999999999, -84.583280000000002)"
Wood County,Ohio,125488,35.299999999999997,98213,15389,61347,64141,"(41.366720000000001, -83.616600000000005)"
Wyandot County,Ohio,22615,40.5,17114,3680,11186,11429,"(40.850059999999999, -83.283249999999995)"
Adair County,Oklahoma,22683,36.200000000000003,16326,2934,11348,11335,"(35.866750000000003, -94.666889999999995)"
Alfalfa County,Oklahoma,5642,46,4624,1142,3323,2319,"(36.733359999999998, -98.333680000000001)"
Atoka County,Oklahoma,14182,39.5,10834,2286,7384,6798,"(34.400089999999999, -96.016930000000002)"
Beaver County,Oklahoma,5636,40.299999999999997,4167,872,2870,2766,"(36.766689999999997, -100.48376)"
Beckham County,Oklahoma,22119,35.4,16781,2813,11831,10288,"(35.266719999999999, -99.66704)"
Blaine County,Oklahoma,11943,36.299999999999997,9391,1724,6924,5019,"(35.866709999999998, -98.45035)"
Bryan County,Oklahoma,42416,37.200000000000003,32503,6680,20743,21673,"(33.966760000000001, -96.266930000000002)"
Caddo County,Oklahoma,29600,37.799999999999997,22111,4343,15296,14304,"(35.183390000000003, -98.400329999999997)"
Canadian County,Oklahoma,115541,35.700000000000003,84447,12576,57334,58207,"(35.533380000000001, -97.98366)"
Carter County,Oklahoma,47557,38.200000000000003,35310,7078,23191,24366,"(34.233429999999998, -97.300299999999993)"
Cherokee County,Oklahoma,46987,34.5,35654,6338,23230,23757,"(35.900089999999999, -94.98357)"
Choctaw County,Oklahoma,15205,41.6,11526,2759,7332,7873,"(34.033439999999999, -95.550240000000002)"
Cimarron County,Oklahoma,2475,44.6,1845,530,1232,1243,"(36.750579999999999, -102.51712999999999)"
Cleveland County,Oklahoma,255755,32.700000000000003,196579,26177,127819,127936,"(35.200069999999997, -97.300309999999996)"
Coal County,Oklahoma,5925,41,4414,1053,2928,2997,"(34.58343, -96.300280000000001)"
Comanche County,Oklahoma,124098,31.3,92964,12702,63925,60173,"(34.666739999999997, -98.483670000000004)"
Cotton County,Oklahoma,6193,41.1,4669,1051,3048,3145,"(34.300089999999997, -98.367000000000004)"
Craig County,Oklahoma,15029,41.9,11616,2621,7641,7388,"(36.750639999999997, -95.200249999999997)"
Creek County,Oklahoma,69967,40,52539,10475,34619,35348,"(35.900080000000003, -96.400289999999998)"
Custer County,Oklahoma,27469,31.2,21059,3671,13632,13837,"(35.65005, -99.000919999999994)"
Delaware County,Oklahoma,41487,45.2,32180,8536,20470,21017,"(36.400080000000003, -94.800229999999999)"
Dewey County,Oklahoma,4810,42.8,3589,958,2402,2408,"(36.000599999999999, -99.000929999999997)"
Ellis County,Oklahoma,4151,43.2,3120,792,2024,2127,"(36.133380000000002, -99.767060000000001)"
Garfield County,Oklahoma,60580,37.4,45632,9296,29873,30707,"(36.187539999999998, -98.062839999999994)"
Garvin County,Oklahoma,27576,39.9,20843,4758,13475,14101,"(34.716749999999998, -97.333640000000003)"
Grady County,Oklahoma,52431,38.299999999999997,39257,7162,26000,26431,"(35.0334, -97.900319999999994)"
Grant County,Oklahoma,4527,45.8,3501,962,2249,2278,"(36.80003, -97.783670000000001)"
Greer County,Oklahoma,6239,40.1,5006,1084,3538,2701,"(34.933390000000003, -99.550370000000001)"
Harmon County,Oklahoma,2922,39.799999999999997,2168,506,1403,1519,"(34.766730000000003, -99.850380000000001)"
Harper County,Oklahoma,3685,40.200000000000003,2755,686,1827,1858,"(36.7667, -99.683729999999997)"
Haskell County,Oklahoma,12769,39.9,9517,2242,6346,6423,"(35.216760000000001, -95.133570000000006)"
Hughes County,Oklahoma,14003,40.1,10896,2411,7539,6464,"(35.066749999999999, -96.266949999999994)"
Jackson County,Oklahoma,26446,34.6,19539,3423,13183,13263,"(34.61674, -99.383700000000005)"
Jefferson County,Oklahoma,6472,42.4,4907,1239,3221,3251,"(34.116759999999999, -97.816980000000001)"
Johnston County,Oklahoma,10957,39.6,8271,1819,5397,5560,"(34.300089999999997, -96.650279999999995)"
Kay County,Oklahoma,46562,39.299999999999997,34781,7932,22960,23602,"(36.850029999999997, -97.150319999999994)"
Kingfisher County,Oklahoma,15034,38.299999999999997,11039,2257,7434,7600,"(35.950040000000001, -97.950329999999994)"
Kiowa County,Oklahoma,9446,43,7239,1734,4680,4766,"(34.933390000000003, -98.967020000000005)"
Latimer County,Oklahoma,11154,40,8481,1944,5649,5505,"(34.900100000000002, -95.266909999999996)"
Le Flore County,Oklahoma,50384,38.6,37939,7641,25296,25088,"(34.900100000000002, -94.733559999999997)"
Lincoln County,Oklahoma,34273,40.4,25532,5252,16972,17301,"(35.700060000000001, -96.866969999999995)"
Logan County,Oklahoma,41848,37.200000000000003,31377,5293,20720,21128,"(35.883380000000002, -97.43365)"
Love County,Oklahoma,9423,40.700000000000003,7129,1618,4630,4793,"(33.950099999999999, -97.233630000000005)"
McClain County,Oklahoma,34506,38.200000000000003,25311,4566,17126,17380,"(35.016739999999999, -97.516980000000004)"
McCurtain County,Oklahoma,33151,38.799999999999997,24552,5140,16245,16906,"(34.16677, -94.766890000000004)"
McIntosh County,Oklahoma,20252,47,15995,4445,10012,10240,"(35.366770000000002, -95.666929999999994)"
Major County,Oklahoma,7527,43.7,5779,1448,3697,3830,"(36.300040000000003, -98.533690000000007)"
Marshall County,Oklahoma,15840,43.2,12057,3151,7937,7903,"(34.016770000000001, -96.766949999999994)"
Mayes County,Oklahoma,41259,39.4,30745,6471,20572,20687,"(36.299999999999997, -95.266670000000005)"
Murray County,Oklahoma,13488,41,10267,2363,6718,6770,"(34.483420000000002, -97.033630000000002)"
Muskogee County,Oklahoma,70990,37.6,53479,10408,34695,36295,"(35.58343, -95.333579999999998)"
Noble County,Oklahoma,11561,40.700000000000003,8706,1932,5708,5853,"(36.383369999999999, -97.266990000000007)"
Nowata County,Oklahoma,10536,42,7984,1893,5210,5326,"(36.800089999999997, -95.616919999999993)"
Okfuskee County,Oklahoma,12191,40.5,9349,2034,6524,5667,"(35.466749999999998, -96.366950000000003)"
Oklahoma County,Oklahoma,718633,34.299999999999997,537515,86357,351376,367257,"(35.550060000000002, -97.400310000000005)"
Okmulgee County,Oklahoma,40069,38.799999999999997,30196,6334,19854,20215,"(35.650100000000002, -95.966939999999994)"
Osage County,Oklahoma,47472,41.4,35919,7278,23889,23583,"(36.633400000000002, -96.300280000000001)"
Ottawa County,Oklahoma,31848,38.9,23992,5418,15537,16311,"(36.750630000000001, -94.800229999999999)"
Pawnee County,Oklahoma,16577,41.3,12491,2723,8251,8326,"(36.333390000000001, -96.750870000000006)"
Payne County,Oklahoma,77350,27.3,62724,8061,39184,38166,"(36.066719999999997, -96.966980000000007)"
Pittsburg County,Oklahoma,45837,41.2,35717,8036,23270,22567,"(34.950099999999999, -95.766940000000005)"
Pontotoc County,Oklahoma,37492,35.700000000000003,28733,5570,18192,19300,"(34.68759, -96.687790000000007)"
Pottawatomie County,Oklahoma,69442,37,52087,9935,33292,36150,"(35.216740000000001, -96.950299999999999)"
Pushmataha County,Oklahoma,11572,44.3,8977,2338,5721,5851,"(34.450099999999999, -95.366910000000004)"
Roger Mills County,Oklahoma,3647,41.3,2731,645,1812,1835,"(35.700049999999997, -99.700389999999999)"
Rogers County,Oklahoma,86905,38.299999999999997,64189,11609,43053,43852,"(36.366759999999999, -95.583590000000001)"
Seminole County,Oklahoma,25482,39.1,18926,4097,12435,13047,"(35.150080000000003, -96.600290000000001)"
Sequoyah County,Oklahoma,42391,39,31465,6329,21005,21386,"(35.450090000000003, -94.733559999999997)"
Stephens County,Oklahoma,45048,40.6,34224,7798,21961,23087,"(34.466749999999998, -97.850309999999993)"
Texas County,Oklahoma,20640,31.3,14700,2115,10741,9899,"(36.766689999999997, -101.5171)"
Tillman County,Oklahoma,7992,40.9,6017,1414,3992,4000,"(34.366750000000003, -98.917019999999994)"
Tulsa County,Oklahoma,603403,35.200000000000003,449127,72856,294440,308963,"(36.100099999999998, -95.900270000000006)"
Wagoner County,Oklahoma,73085,37.200000000000003,53617,9139,35986,37099,"(35.966769999999997, -95.550250000000005)"
Washington County,Oklahoma,50976,41.1,39023,9083,24664,26312,"(36.716760000000001, -95.900260000000003)"
Washita County,Oklahoma,11629,39,8627,1987,5675,5954,"(35.300049999999999, -99.000910000000005)"
Woods County,Oklahoma,8878,34.700000000000003,7211,1523,4746,4132,"(36.7667, -98.800370000000001)"
Woodward County,Oklahoma,20081,37,15196,2848,10519,9562,"(36.5167, -99.21705)"
Baker County,Oregon,16134,47.9,12854,3542,8140,7994,"(44.750160000000001, -117.66771)"
Benton County,Oregon,85579,32.1,70330,10280,42868,42711,"(44.499569999999999, -123.41788)"
Clackamas County,Oregon,375992,40.6,286761,51231,184925,191067,"(45.249560000000002, -122.16786)"
Clatsop County,Oregon,37039,43.2,29438,6160,18407,18632,"(45.966500000000003, -123.66791000000001)"
Columbia County,Oregon,49351,41.3,37732,6883,24722,24629,"(45.916499999999999, -123.08456)"
Coos County,Oregon,63043,47.3,51113,13486,31086,31957,"(43.166499999999999, -124.00149)"
Crook County,Oregon,20978,45.6,16378,4203,10398,10580,"(44.166530000000002, -120.08443)"
Curry County,Oregon,22364,53.5,18853,6261,11041,11323,"(42.500109999999999, -124.21787)"
Deschutes County,Oregon,157733,40.200000000000003,121512,23491,77971,79762,"(43.916510000000002, -121.25142)"
Douglas County,Oregon,107667,46.1,85573,22570,53151,54516,"(43.333170000000003, -123.16785)"
Gilliam County,Oregon,1871,49.7,1518,415,965,906,"(45.333179999999999, -120.26782)"
Grant County,Oregon,7445,50,6015,1760,3699,3746,"(44.500149999999998, -119.00135)"
Harney County,Oregon,7422,45.2,5758,1402,3778,3644,"(43.166539999999998, -119.00132000000001)"
Hood River County,Oregon,22346,38,16539,2807,11173,11173,"(45.500120000000003, -121.63451999999999)"
Jackson County,Oregon,203206,42.1,158894,35834,99002,104204,"(42.416510000000002, -122.83448)"
Jefferson County,Oregon,21720,39.6,16230,3331,11256,10464,"(44.63317, -121.33449)"
Josephine County,Oregon,82713,47.3,65830,18438,40240,42473,"(42.416499999999999, -123.58450999999999)"
Klamath County,Oregon,66380,41.7,51577,11351,33051,33329,"(42.666530000000002, -121.75085)"
Lake County,Oregon,7895,47.4,6370,1612,4163,3732,"(42.833210000000001, -120.50136000000001)"
Lane County,Oregon,351715,39,282026,52781,173044,178671,"(43.916510000000002, -122.83452)"
Lincoln County,Oregon,46034,49.6,38081,9972,22402,23632,"(44.666510000000002, -123.83456)"
Linn County,Oregon,116672,39.200000000000003,88499,17991,57578,59094,"(44.499569999999999, -122.58453)"
Malheur County,Oregon,31313,36.200000000000003,23309,4694,16926,14387,"(43.250160000000001, -117.66767)"
Marion County,Oregon,315335,35.1,231954,40549,157117,158218,"(44.866509999999998, -122.6512)"
Morrow County,Oregon,11173,36.5,7983,1421,5749,5424,"(45.499569999999999, -119.55113)"
Multnomah County,Oregon,735334,35.700000000000003,584651,77423,363645,371689,"(45.500120000000003, -122.41786999999999)"
Polk County,Oregon,75403,37.1,57070,11152,36689,38714,"(44.866509999999998, -123.45122000000001)"
Sherman County,Oregon,1765,48.2,1416,384,896,869,"(45.416510000000002, -120.66783)"
Tillamook County,Oregon,25250,47.5,20245,5273,12740,12510,"(45.516500000000001, -123.7179)"
Umatilla County,Oregon,75889,35.700000000000003,55689,9657,39528,36361,"(45.500129999999999, -118.50135)"
Union County,Oregon,25748,40,19951,4308,12678,13070,"(45.366520000000001, -118.00133)"
Wallowa County,Oregon,7008,50.5,5689,1626,3439,3569,"(45.500149999999998, -117.16766)"
Wasco County,Oregon,25213,41.7,19365,4450,12506,12707,"(45.166510000000002, -121.25145000000001)"
Washington County,Oregon,529710,35.299999999999997,393872,53109,260524,269186,"(45.514049999999997, -123.00293000000001)"
Wheeler County,Oregon,1441,53,1182,420,718,723,"(44.666530000000002, -120.00139)"
Yamhill County,Oregon,99193,36.799999999999997,74364,13266,49787,49406,"(45.216500000000003, -123.30122)"
Adams County,Pennsylvania,101407,41.3,78969,15954,49865,51542,"(39.750369999999997, -77.374989999999997)"
Allegheny County,Pennsylvania,1223348,41.3,981685,205059,585650,637698,"(40.625340000000001, -80.125060000000005)"
Armstrong County,Pennsylvania,68941,44.5,54752,12687,34013,34928,"(41.125340000000001, -79.683099999999996)"
Beaver County,Pennsylvania,170539,44.4,135661,31660,82279,88260,"(40.750340000000001, -80.500069999999994)"
Bedford County,Pennsylvania,49762,43.9,39023,9476,24705,25057,"(40.250349999999997, -78.625020000000006)"
Berks County,Pennsylvania,411442,39.1,313306,59558,201864,209578,"(40.625369999999997, -75.874920000000003)"
Blair County,Pennsylvania,127089,42,100211,22527,61708,65381,"(40.625070000000001, -78.375020000000006)"
Bradford County,Pennsylvania,62622,43.4,48384,11152,30828,31794,"(41.875349999999997, -76.874960000000002)"
Bucks County,Pennsylvania,625249,42,481735,91219,306663,318586,"(40.50038, -75.374899999999997)"
Butler County,Pennsylvania,183862,41.5,142596,27853,90491,93371,"(41.125340000000001, -80.000060000000005)"
Cambria County,Pennsylvania,143679,43.8,115444,27071,71003,72676,"(40.625349999999997, -78.750029999999995)"
Cameron County,Pennsylvania,5085,48.2,4100,1086,2499,2586,"(41.500340000000001, -78.375020000000006)"
Carbon County,Pennsylvania,65249,43.9,51709,11644,32173,33076,"(41.125360000000001, -75.674629999999993)"
Centre County,Pennsylvania,153990,28.7,129478,17366,79763,74227,"(41.250340000000001, -77.899720000000002)"
Chester County,Pennsylvania,498886,39.299999999999997,374831,63875,245161,253725,"(40.12538, -75.874939999999995)"
Clarion County,Pennsylvania,39988,39.4,32233,6566,19367,20621,"(41.375340000000001, -79.375039999999998)"
Clearfield County,Pennsylvania,81642,42.9,65346,14258,42126,39516,"(41.125340000000001, -78.750029999999995)"
Clinton County,Pennsylvania,39238,38.5,31121,6350,19231,20007,"(41.375340000000001, -77.874989999999997)"
Columbia County,Pennsylvania,67295,39.5,54739,10811,32276,35019,"(41.250360000000001, -76.374939999999995)"
Crawford County,Pennsylvania,88765,41.7,68854,14712,43333,45432,"(41.750329999999998, -80.500069999999994)"
Cumberland County,Pennsylvania,235406,40.299999999999997,186694,36745,115589,119817,"(40.250360000000001, -77.374979999999994)"
Dauphin County,Pennsylvania,268100,39.4,205885,36841,129619,138481,"(40.627859999999998, -76.752470000000002)"
Delaware County,Pennsylvania,558979,38.700000000000003,428567,79726,267849,291130,"(40.000390000000003, -75.37491)"
Elk County,Pennsylvania,31946,45.1,25295,6066,15872,16074,"(41.626449999999998, -78.641409999999993)"
Erie County,Pennsylvania,280566,38.6,216758,40824,137957,142609,"(42.125329999999998, -79.875050000000002)"
Fayette County,Pennsylvania,136606,43.6,108926,24580,67007,69599,"(40.125349999999997, -79.750039999999998)"
Forest County,Pennsylvania,7716,43,6759,1418,5164,2552,"(41.500340000000001, -79.500050000000002)"
Franklin County,Pennsylvania,149618,40.1,113878,24679,73184,76434,"(40.250360000000001, -77.666380000000004)"
Fulton County,Pennsylvania,14845,41.8,11414,2544,7471,7374,"(40.125360000000001, -78.125010000000003)"
Greene County,Pennsylvania,38686,41.1,31006,5931,19929,18757,"(40.000349999999997, -80.250060000000005)"
Huntingdon County,Pennsylvania,45913,41.2,36669,7458,24278,21635,"(40.625340000000001, -78.125010000000003)"
Indiana County,Pennsylvania,88880,38.299999999999997,72034,13944,44200,44680,"(40.875340000000001, -79.125039999999998)"
Jefferson County,Pennsylvania,45200,43,35443,8255,22301,22899,"(41.250340000000001, -79.125039999999998)"
Juniata County,Pennsylvania,24636,40.9,18723,4134,12286,12350,"(40.625349999999997, -77.374989999999997)"
Lackawanna County,Pennsylvania,214437,41.8,170490,37895,103119,111318,"(41.625360000000001, -75.62491)"
Lancaster County,Pennsylvania,519445,38.200000000000003,390430,77780,253836,265609,"(40.250369999999997, -76.249949999999998)"
Lawrence County,Pennsylvania,91108,43.6,71756,17128,43909,47199,"(41.000340000000001, -80.500069999999994)"
Lebanon County,Pennsylvania,133568,41,102803,22729,65161,68407,"(40.500369999999997, -76.624970000000005)"
Lehigh County,Pennsylvania,349497,39.4,266817,51604,169312,180185,"(40.750369999999997, -75.62491)"
Luzerne County,Pennsylvania,320918,42.5,256118,57595,156829,164089,"(41.375360000000001, -76.249930000000006)"
Lycoming County,Pennsylvania,116111,41.1,91899,19112,56839,59272,"(41.500349999999997, -77.499979999999994)"
McKean County,Pennsylvania,43450,41.5,34301,7381,22159,21291,"(41.875340000000001, -78.875039999999998)"
Mercer County,Pennsylvania,116638,42.8,91409,21556,57106,59532,"(41.375329999999998, -80.500069999999994)"
Mifflin County,Pennsylvania,46682,42.5,35898,8643,22842,23840,"(40.750349999999997, -77.5)"
Monroe County,Pennsylvania,169842,40.299999999999997,129268,21701,83856,85986,"(41.250369999999997, -75.149619999999999)"
Montgomery County,Pennsylvania,799874,40.6,616375,120727,387964,411910,"(40.37538, -75.499899999999997)"
Montour County,Pennsylvania,18267,43.9,14393,3395,8784,9483,"(41.125360000000001, -76.64134)"
Northampton County,Pennsylvania,297735,40.9,232558,46606,145386,152349,"(40.875369999999997, -75.249899999999997)"
Northumberland County,Pennsylvania,94528,43.4,75085,17516,47195,47333,"(40.850090000000002, -76.666349999999994)"
Perry County,Pennsylvania,45969,41.1,35263,6294,23057,22912,"(40.500360000000001, -77.249989999999997)"
Philadelphia County,Pennsylvania,1526006,33.5,1182169,185309,719813,806193,"(40.125390000000003, -74.999889999999994)"
Pike County,Pennsylvania,57369,43.7,44011,9303,28686,28683,"(41.500369999999997, -75.124889999999994)"
Potter County,Pennsylvania,17457,44.9,13556,3403,8724,8733,"(42.000340000000001, -78.125010000000003)"
Schuylkill County,Pennsylvania,148289,43.2,118551,26828,75175,73114,"(40.875360000000001, -76.249939999999995)"
Snyder County,Pennsylvania,39702,39.200000000000003,30808,6144,19597,20105,"(40.770919999999997, -77.084429999999998)"
Somerset County,Pennsylvania,77742,44.3,62611,14431,40029,37713,"(40.250349999999997, -79.000029999999995)"
Sullivan County,Pennsylvania,6428,49.9,5402,1557,3307,3121,"(41.500349999999997, -76.749960000000002)"
Susquehanna County,Pennsylvania,43356,45.1,34189,7845,21795,21561,"(41.875349999999997, -76.124930000000006)"
Tioga County,Pennsylvania,41981,42.4,33391,7562,20573,21408,"(41.875349999999997, -77.499979999999994)"
Union County,Pennsylvania,44947,38.5,36637,6654,24711,20236,"(41.125360000000001, -76.916349999999994)"
Venango County,Pennsylvania,54984,44.3,43152,9884,26910,28074,"(41.500329999999998, -79.875060000000005)"
Warren County,Pennsylvania,41815,45.1,33097,7840,20827,20988,"(41.875340000000001, -79.500050000000002)"
Washington County,Pennsylvania,207820,43.6,165136,36366,101035,106785,"(40.375349999999997, -80.500069999999994)"
Wayne County,Pennsylvania,52822,45.9,42780,10028,27704,25118,"(41.875360000000001, -75.374899999999997)"
Westmoreland County,Pennsylvania,365169,45.1,292558,68877,177722,187447,"(40.625340000000001, -79.625050000000002)"
Wyoming County,Pennsylvania,28276,42.3,22127,4528,14134,14142,"(41.625349999999997, -76.124930000000006)"
York County,Pennsylvania,434972,40.1,332958,61057,214563,220409,"(40.125369999999997, -76.999979999999994)"
Bristol County,Rhode Island,49875,42.9,39715,8343,23951,25924,"(41.716769999999997, -71.271720000000002)"
Kent County,Rhode Island,166158,42.7,131904,26069,79969,86189,"(41.66677, -71.599509999999995)"
Newport County,Rhode Island,82888,43.2,66462,14063,40409,42479,"(41.583440000000003, -71.249489999999994)"
Providence County,Rhode Island,626667,37,489042,84389,302382,324285,"(41.83343, -71.599509999999995)"
Washington County,Rhode Island,126979,42.3,101488,19017,61689,65290,"(41.500660000000003, -71.616169999999997)"
Abbeville County,South Carolina,25417,41.6,19630,4203,12321,13096,"(34.233449999999998, -82.466520000000003)"
Aiken County,South Carolina,160099,40,123271,24619,77550,82549,"(33.583480000000002, -81.599829999999997)"
Allendale County,South Carolina,10419,38.799999999999997,8093,1375,5540,4879,"(33.000430000000001, -81.349829999999997)"
Anderson County,South Carolina,187126,39.700000000000003,142301,28329,90255,96871,"(34.533439999999999, -82.649860000000004)"
Bamberg County,South Carolina,15987,39.299999999999997,12414,2565,7605,8382,"(33.216819999999998, -81.033150000000006)"
Barnwell County,South Carolina,22621,38.799999999999997,16823,3173,10809,11812,"(33.26681, -81.466499999999996)"
Beaufort County,South Carolina,162233,40.6,127885,33032,80089,82144,"(32.366860000000003, -80.699830000000006)"
Berkeley County,South Carolina,177843,34.5,132881,17794,88729,89114,"(33.183500000000002, -79.949799999999996)"
Calhoun County,South Carolina,15175,43.4,11880,2470,7397,7778,"(33.683489999999999, -80.766480000000001)"
Charleston County,South Carolina,350209,35.9,277551,44721,169871,180338,"(32.766840000000002, -79.966480000000004)"
Cherokee County,South Carolina,55342,38.299999999999997,41688,7442,26860,28482,"(35.050130000000003, -81.599819999999994)"
Chester County,South Carolina,33140,40.299999999999997,25212,4835,16018,17122,"(34.68347, -81.133139999999997)"
Chesterfield County,South Carolina,46734,39.299999999999997,35177,6332,22697,24037,"(34.650149999999996, -80.166449999999998)"
Clarendon County,South Carolina,34971,41.4,27162,5867,17271,17700,"(33.666829999999997, -80.233140000000006)"
Colleton County,South Carolina,38892,40.700000000000003,29400,6078,18747,20145,"(32.850169999999999, -80.666489999999996)"
Darlington County,South Carolina,68681,39.6,52023,9793,32555,36126,"(34.333489999999998, -79.966449999999995)"
Dillon County,South Carolina,32062,36.700000000000003,23488,4159,15084,16978,"(34.416829999999997, -79.416439999999994)"
Dorchester County,South Carolina,136555,35.6,99529,13849,66381,70174,"(33.100169999999999, -80.383150000000001)"
Edgefield County,South Carolina,26985,40.299999999999997,21214,3524,14568,12417,"(33.783470000000001, -81.966499999999996)"
Fairfield County,South Carolina,23956,42.4,18525,3565,11473,12483,"(34.48348, -81.099810000000005)"
Florence County,South Carolina,136885,37.6,103185,18017,64319,72566,"(34.050159999999998, -79.666449999999998)"
Georgetown County,South Carolina,60158,45.4,47138,11920,28648,31510,"(33.45017, -79.349779999999996)"
Greenville County,South Carolina,451225,37.200000000000003,341908,57581,218791,232434,"(34.883450000000003, -82.366510000000005)"
Greenwood County,South Carolina,69661,37.9,53154,10544,32654,37007,"(34.166789999999999, -82.116510000000005)"
Hampton County,South Carolina,21090,38.4,15999,2829,10807,10283,"(32.800170000000001, -81.116489999999999)"
Horry County,South Carolina,269291,41.1,215049,46070,131691,137600,"(33.916840000000001, -78.983090000000004)"
Jasper County,South Carolina,24777,34.6,18636,2769,12905,11872,"(32.41686, -81.016499999999994)"
Kershaw County,South Carolina,61697,40.200000000000003,46558,8797,30017,31680,"(34.450150000000001, -80.566460000000006)"
Lancaster County,South Carolina,76652,39.700000000000003,58821,11737,37762,38890,"(34.700150000000001, -80.766459999999995)"
Laurens County,South Carolina,66537,39.9,51110,9988,32298,34239,"(34.500399999999999, -82.000370000000004)"
Lee County,South Carolina,19220,38.9,14957,2596,9950,9270,"(34.166820000000001, -80.28313)"
Lexington County,South Carolina,262391,37.9,198229,32111,128134,134257,"(33.900149999999996, -81.299819999999997)"
McCormick County,South Carolina,10233,50,8751,2449,5558,4675,"(33.900120000000001, -82.299850000000006)"
Marion County,South Carolina,33062,39.9,24991,4852,15116,17946,"(34.083489999999998, -79.433109999999999)"
Marlboro County,South Carolina,28933,38.799999999999997,22610,3779,15260,13673,"(34.583489999999998, -79.666449999999998)"
Newberry County,South Carolina,37508,39.9,28964,5959,18255,19253,"(34.300139999999999, -81.616500000000002)"
Oconee County,South Carolina,74273,43.4,58566,14106,36682,37591,"(34.766759999999998, -83.083209999999994)"
Orangeburg County,South Carolina,92501,38.1,71062,13734,43455,49046,"(33.433489999999999, -80.766480000000001)"
Pickens County,South Carolina,119224,34.9,94937,15993,59553,59671,"(34.916780000000003, -82.716520000000003)"
Richland County,South Carolina,384504,32.6,296951,37541,187330,197174,"(34.016820000000003, -80.916480000000007)"
Saluda County,South Carolina,19875,39.6,15294,3195,9989,9886,"(34.000689999999999, -81.750380000000007)"
Spartanburg County,South Carolina,284307,38,214857,38227,137769,146538,"(34.930680000000002, -81.983159999999998)"
Sumter County,South Carolina,107456,35.4,80025,13921,51732,55724,"(33.866819999999997, -80.399799999999999)"
Union County,South Carolina,28961,41.9,22361,4769,13780,15181,"(34.700130000000001, -81.633160000000004)"
Williamsburg County,South Carolina,34423,40.200000000000003,26301,5039,16734,17689,"(33.633499999999998, -79.73312)"
York County,South Carolina,226073,37.200000000000003,168329,25626,109092,116981,"(34.983469999999997, -81.183130000000006)"
Aurora County,South Dakota,2710,43.2,1985,539,1381,1329,"(43.719439999999999, -98.558700000000002)"
Beadle County,South Dakota,17398,41.2,13179,3006,8755,8643,"(44.386099999999999, -98.280919999999995)"
Bennett County,South Dakota,3431,28.7,2242,384,1684,1747,"(43.183329999999998, -101.68376000000001)"
Bon Homme County,South Dakota,7070,43.1,5675,1347,4129,2941,"(42.975000000000001, -97.867009999999993)"
Brookings County,South Dakota,31965,26.3,25927,3170,16382,15583,"(44.308300000000003, -96.816999999999993)"
Brown County,South Dakota,36531,38.6,28058,5873,17795,18736,"(45.552750000000003, -98.308710000000005)"
Brule County,South Dakota,5255,41.3,3897,914,2553,2702,"(43.719439999999999, -99.051760000000002)"
Buffalo County,South Dakota,1912,25,1162,137,937,975,"(44.052770000000002, -99.175380000000004)"
Butte County,South Dakota,10110,41.1,7583,1591,5086,5024,"(44.883319999999998, -103.55047)"
Campbell County,South Dakota,1466,50.1,1187,370,744,722,"(45.799990000000001, -100.0504)"
Charles Mix County,South Dakota,9129,38.200000000000003,6424,1619,4517,4612,"(43.191659999999999, -98.503140000000002)"
Clark County,South Dakota,3691,45.7,2815,804,1854,1837,"(44.83052, -97.750360000000001)"
Clay County,South Dakota,13864,25,11440,1421,6740,7124,"(42.91666, -96.958659999999995)"
Codington County,South Dakota,27227,37.700000000000003,20478,4051,13570,13657,"(44.958300000000001, -97.186459999999997)"
Corson County,South Dakota,4050,29.7,2660,423,2067,1983,"(45.75, -101.12542000000001)"
Custer County,South Dakota,8216,50.3,6586,1766,4150,4066,"(43.674979999999998, -103.4838)"
Davison County,South Dakota,19504,37.799999999999997,14919,3301,9656,9848,"(43.666649999999997, -98.175359999999998)"
Day County,South Dakota,5710,47.9,4463,1309,2867,2843,"(45.31662, -97.583699999999993)"
Deuel County,South Dakota,4364,43.9,3336,839,2250,2114,"(44.758299999999998, -96.647559999999999)"
Dewey County,South Dakota,5301,30,3498,515,2601,2700,"(45.141649999999998, -100.87598)"
Douglas County,South Dakota,3002,48.3,2315,727,1505,1497,"(43.391660000000002, -98.375360000000001)"
Edmunds County,South Dakota,4071,45.7,3094,883,2069,2002,"(45.399979999999999, -99.200389999999999)"
Fall River County,South Dakota,7094,50.5,5760,1638,3603,3491,"(43.266640000000002, -103.55047)"
Faulk County,South Dakota,2364,46.9,1809,560,1170,1194,"(45.06664, -99.150390000000002)"
Grant County,South Dakota,7356,45.1,5655,1363,3740,3616,"(45.191630000000004, -96.750339999999994)"
Gregory County,South Dakota,4271,48.2,3307,1013,2149,2122,"(43.158329999999999, -99.208709999999996)"
Haakon County,South Dakota,1937,48.8,1506,421,980,957,"(44.280540000000002, -101.58376)"
Hamlin County,South Dakota,5903,36.799999999999997,4098,1020,2950,2953,"(44.666629999999998, -97.175349999999995)"
Hand County,South Dakota,3431,48.2,2716,867,1701,1730,"(44.541649999999997, -99.000380000000007)"
Hanson County,South Dakota,3331,35.5,2250,467,1669,1662,"(43.666649999999997, -97.783680000000004)"
Harding County,South Dakota,1255,43.3,963,182,659,596,"(45.583329999999997, -103.50102)"
Hughes County,South Dakota,17022,39.799999999999997,12985,2285,8281,8741,"(44.416649999999997, -99.983729999999994)"
Hutchinson County,South Dakota,7343,46.8,5601,1838,3575,3768,"(43.316650000000003, -97.76979)"
Hyde County,South Dakota,1420,46.4,1102,321,739,681,"(44.549979999999998, -99.461500000000001)"
Jackson County,South Dakota,3031,31.5,2034,407,1527,1504,"(43.686109999999999, -101.67542)"
Jerauld County,South Dakota,2071,48.6,1636,519,1007,1064,"(44.06944, -98.625370000000004)"
Jones County,South Dakota,1006,46.9,781,207,498,508,"(43.958320000000001, -100.67819)"
Kingsbury County,South Dakota,5148,47.1,4022,1120,2610,2538,"(44.366639999999997, -97.483689999999996)"
Lake County,South Dakota,11200,39.9,8775,1893,5693,5507,"(44.036079999999998, -97.125339999999994)"
Lawrence County,South Dakota,24097,41,19377,3993,11935,12162,"(44.36665, -103.81715)"
Lincoln County,South Dakota,44828,32.799999999999997,31529,4032,22193,22635,"(43.293039999999998, -96.749769999999998)"
Lyman County,South Dakota,3755,36.1,2649,548,1966,1789,"(43.933320000000002, -99.875389999999996)"
McCook County,South Dakota,5618,42.7,4164,1066,2810,2808,"(43.683309999999999, -97.267009999999999)"
McPherson County,South Dakota,2459,50.8,1923,733,1202,1257,"(45.774979999999999, -99.244839999999996)"
Marshall County,South Dakota,4656,43.2,3620,887,2520,2136,"(45.769399999999997, -97.594819999999999)"
Meade County,South Dakota,25434,35.9,19019,3038,12961,12473,"(44.500540000000001, -102.626)"
Mellette County,South Dakota,2048,34.200000000000003,1387,277,1048,1000,"(43.558329999999998, -100.75042000000001)"
Miner County,South Dakota,2389,46.4,1813,532,1207,1182,"(44.044420000000002, -97.624799999999993)"
Minnehaha County,South Dakota,169468,34.5,126905,18843,84537,84931,"(43.666640000000001, -96.758660000000006)"
Moody County,South Dakota,6486,40.5,4791,983,3248,3238,"(44.041640000000001, -96.658659999999998)"
Pennington County,South Dakota,100948,36.799999999999997,76111,13617,50306,50642,"(43.983319999999999, -102.76712000000001)"
Perkins County,South Dakota,2982,48.5,2343,690,1498,1484,"(45.516649999999998, -102.45877)"
Potter County,South Dakota,2329,50.6,1873,627,1154,1175,"(45.049979999999998, -99.950400000000002)"
Roberts County,South Dakota,10149,39.5,7269,1758,5098,5051,"(45.516629999999999, -96.983689999999996)"
Sanborn County,South Dakota,2355,47.1,1842,477,1220,1135,"(44.033329999999999, -98.083609999999993)"
Shannon County,South Dakota,13586,23.5,8244,799,6701,6885,"(43.352760000000004, -102.55045)"
Spink County,South Dakota,6415,44.4,4818,1291,3227,3188,"(44.936079999999997, -98.317040000000006)"
Stanley County,South Dakota,2966,41.9,2245,469,1483,1483,"(44.441650000000003, -100.80042)"
Sully County,South Dakota,1373,46.6,1063,263,742,631,"(44.68609, -100.16707)"
Todd County,South Dakota,9612,24,5755,593,4723,4889,"(43.183340000000001, -100.74986)"
Tripp County,South Dakota,5644,45.3,4321,1187,2781,2863,"(43.35, -99.875950000000003)"
Turner County,South Dakota,8347,43.7,6363,1583,4191,4156,"(43.308320000000002, -97.125889999999998)"
Union County,South Dakota,14399,40.200000000000003,10632,2022,7218,7181,"(42.816659999999999, -96.694760000000002)"
Walworth County,South Dakota,5438,47.2,4234,1303,2655,2783,"(45.516649999999998, -99.88373)"
Yankton County,South Dakota,22438,41.3,17464,3665,11556,10882,"(43.05, -97.383669999999995)"
Ziebach County,South Dakota,2801,25.4,1706,195,1358,1443,"(44.883319999999998, -101.63377)"
Anderson County,Tennessee,75129,42.6,58665,13064,36308,38821,"(36.116750000000003, -84.216589999999997)"
Bedford County,Tennessee,45058,36.4,32989,5834,22357,22701,"(35.516739999999999, -86.44999)"
Benton County,Tennessee,16489,45.5,13108,3281,8073,8416,"(36.083390000000001, -88.083370000000002)"
Bledsoe County,Tennessee,12876,42.3,10108,1977,6964,5912,"(35.600070000000002, -85.216629999999995)"
Blount County,Tennessee,123010,41.4,95634,19770,59559,63451,"(35.70008, -83.9499)"
Bradley County,Tennessee,98963,38.200000000000003,76227,13999,48176,50787,"(35.150069999999999, -84.866609999999994)"
Campbell County,Tennessee,40716,41.7,31767,7011,19861,20855,"(36.400080000000003, -84.133260000000007)"
Cannon County,Tennessee,13801,41.4,10700,2216,6831,6970,"(35.800069999999998, -86.049989999999994)"
Carroll County,Tennessee,28522,42,22269,5103,13776,14746,"(35.966729999999998, -88.466719999999995)"
Carter County,Tennessee,57424,42.2,45892,9818,28097,29327,"(36.300109999999997, -82.133179999999996)"
Cheatham County,Tennessee,39105,39.299999999999997,29353,4250,19535,19570,"(36.266719999999999, -87.1)"
Chester County,Tennessee,17131,36.200000000000003,13141,2500,8273,8858,"(35.433410000000002, -88.600049999999996)"
Claiborne County,Tennessee,32213,41.1,25438,5142,15779,16434,"(36.483409999999999, -83.666579999999996)"
Clay County,Tennessee,7861,45.1,6220,1579,3897,3964,"(36.550060000000002, -85.533299999999997)"
Cocke County,Tennessee,35662,42.9,28011,5965,17308,18354,"(35.950099999999999, -83.099879999999999)"
Coffee County,Tennessee,52796,39.700000000000003,39936,8322,25655,27141,"(35.483409999999999, -86.066649999999996)"
Crockett County,Tennessee,14586,39.6,11015,2395,6997,7589,"(35.783410000000003, -89.133399999999995)"
Cumberland County,Tennessee,56053,48.3,45374,14553,27381,28672,"(35.950069999999997, -84.966620000000006)"
Davidson County,Tennessee,626681,33.9,490290,65403,303540,323141,"(36.150060000000003, -86.783330000000007)"
Decatur County,Tennessee,11757,44.3,9232,2428,5798,5959,"(35.633400000000002, -88.116699999999994)"
DeKalb County,Tennessee,18723,41,14432,2956,9270,9453,"(35.966729999999998, -85.849990000000005)"
Dickson County,Tennessee,49666,38.700000000000003,37229,6585,24384,25282,"(36.150060000000003, -87.366680000000002)"
Dyer County,Tennessee,38335,39.299999999999997,28783,5517,18469,19866,"(36.050069999999998, -89.400069999999999)"
Fayette County,Tennessee,38413,41.9,29535,5714,19047,19366,"(35.200090000000003, -89.416740000000004)"
Fentress County,Tennessee,17959,42.3,13805,3047,8853,9106,"(36.383400000000002, -84.933279999999996)"
Franklin County,Tennessee,41052,41.3,32093,7109,20027,21025,"(35.16675, -86.083320000000001)"
Gibson County,Tennessee,49683,39.9,37284,8187,23668,26015,"(36.000349999999997, -88.933400000000006)"
Giles County,Tennessee,29485,42.1,22976,4910,14379,15106,"(35.233409999999999, -87.033339999999995)"
Grainger County,Tennessee,22657,42.1,17609,3625,11286,11371,"(36.266750000000002, -83.483230000000006)"
Greene County,Tennessee,68831,42.6,54248,12006,33766,35065,"(36.150100000000002, -82.849869999999996)"
Grundy County,Tennessee,13703,41.4,10535,2401,6785,6918,"(35.266750000000002, -85.833309999999997)"
Hamblen County,Tennessee,62544,39.6,47804,9918,30453,32091,"(36.200090000000003, -83.266559999999998)"
Hamilton County,Tennessee,336463,39.299999999999997,263852,49415,161906,174557,"(35.200069999999997, -85.149959999999993)"
Hancock County,Tennessee,6819,42.9,5323,1159,3366,3453,"(36.53342, -83.25018)"
Hardeman County,Tennessee,27253,39.200000000000003,21476,3811,14816,12437,"(35.216749999999998, -88.98339)"
Hardin County,Tennessee,26026,43.5,20381,4809,12678,13348,"(35.183410000000002, -88.166700000000006)"
Hawkins County,Tennessee,56833,42.1,44143,9367,27829,29004,"(36.433430000000001, -82.949889999999996)"
Haywood County,Tennessee,18787,39.200000000000003,13977,2583,8845,9942,"(35.600079999999998, -89.266739999999999)"
Henderson County,Tennessee,27769,39.700000000000003,21012,4112,13362,14407,"(35.650069999999999, -88.400049999999993)"
Henry County,Tennessee,32330,44.3,25302,6364,15633,16697,"(36.333390000000001, -88.31671)"
Hickman County,Tennessee,24690,40,19128,3440,12954,11736,"(35.800069999999998, -87.483350000000002)"
Houston County,Tennessee,8426,41.8,6434,1503,4144,4282,"(36.300060000000002, -87.733350000000002)"
Humphreys County,Tennessee,18538,41.9,14245,3205,9115,9423,"(36.050060000000002, -87.766689999999997)"
Jackson County,Tennessee,11638,44.7,9267,2055,5810,5828,"(36.366729999999997, -85.649979999999999)"
Jefferson County,Tennessee,51407,40.799999999999997,40048,8334,25245,26162,"(36.050089999999997, -83.449889999999996)"
Johnson County,Tennessee,18244,43.3,14882,3228,9833,8411,"(36.466790000000003, -81.84984)"
Knox County,Tennessee,432226,37.200000000000003,337736,56491,210085,222141,"(36.016750000000002, -83.933239999999998)"
Lake County,Tennessee,7832,38.299999999999997,6523,1074,4987,2845,"(36.333399999999997, -89.466740000000001)"
Lauderdale County,Tennessee,27815,36.4,21068,3424,14603,13212,"(35.766739999999999, -89.600080000000005)"
Lawrence County,Tennessee,41869,39.700000000000003,31340,6738,20432,21437,"(35.216749999999998, -87.400019999999998)"
Lewis County,Tennessee,12161,41.2,9263,1971,5954,6207,"(35.516739999999999, -87.483350000000002)"
Lincoln County,Tennessee,33361,41.8,25575,5550,16268,17093,"(35.150080000000003, -86.6)"
Loudon County,Tennessee,48556,46,38688,10434,23828,24728,"(35.733409999999999, -84.316590000000005)"
McMinn County,Tennessee,52266,41.6,40471,8813,25387,26879,"(35.433410000000002, -84.599930000000001)"
McNairy County,Tennessee,26075,41.6,19957,4507,12804,13271,"(35.20008, -88.533379999999994)"
Macon County,Tennessee,22248,38.700000000000003,16681,3134,10959,11289,"(36.533380000000001, -86.033320000000003)"
Madison County,Tennessee,98294,36.799999999999997,74660,12932,46648,51646,"(35.61674, -88.850059999999999)"
Marion County,Tennessee,28237,42.3,22080,4493,13871,14366,"(35.150080000000003, -85.633300000000006)"
Marshall County,Tennessee,30617,38.9,23067,4018,14965,15652,"(35.466740000000001, -86.766670000000005)"
Maury County,Tennessee,80956,38.4,61299,10479,39155,41801,"(35.633400000000002, -87.066670000000002)"
Meigs County,Tennessee,11753,42.9,9227,1885,5847,5906,"(35.500349999999997, -84.799940000000007)"
Monroe County,Tennessee,44519,41.6,34341,7318,22021,22498,"(35.45008, -84.233249999999998)"
Montgomery County,Tennessee,172331,30,124117,13791,84454,87877,"(36.483379999999997, -87.483339999999998)"
Moore County,Tennessee,6362,43.3,4951,1168,3129,3233,"(35.283410000000003, -86.349990000000005)"
Morgan County,Tennessee,21987,39.799999999999997,17364,3015,12107,9880,"(36.133409999999998, -84.633269999999996)"
Obion County,Tennessee,31807,41.4,24538,5329,15326,16481,"(36.383400000000002, -89.150069999999999)"
Overton County,Tennessee,22083,41.6,16954,3711,10899,11184,"(36.450060000000001, -85.283299999999997)"
Perry County,Tennessee,7915,43.1,6129,1483,3974,3941,"(35.650069999999999, -87.866690000000006)"
Pickett County,Tennessee,5077,47.2,4103,1140,2550,2527,"(36.550069999999998, -85.06662)"
Polk County,Tennessee,16825,42.5,13100,2872,8371,8454,"(35.133409999999998, -84.500209999999996)"
Putnam County,Tennessee,72321,35.9,56754,10565,35818,36503,"(36.166730000000001, -85.649979999999999)"
Rhea County,Tennessee,31809,39.799999999999997,24353,4996,15568,16241,"(35.633400000000002, -84.933279999999996)"
Roane County,Tennessee,54181,44.9,42896,10055,26628,27553,"(35.850070000000002, -84.533270000000002)"
Robertson County,Tennessee,66283,37.6,49241,7804,32634,33649,"(36.516710000000003, -86.866659999999996)"
Rutherford County,Tennessee,262604,32.200000000000003,193890,21566,129726,132878,"(35.850070000000002, -86.399990000000003)"
Scott County,Tennessee,22228,38.1,16598,3053,10911,11317,"(36.45008, -84.51661)"
Sequatchie County,Tennessee,14112,40.6,10788,2200,7006,7106,"(35.333399999999997, -85.383300000000006)"
Sevier County,Tennessee,89889,40.9,69997,13917,44313,45576,"(35.766759999999998, -83.516549999999995)"
Shelby County,Tennessee,927644,34.6,682902,95224,442652,484992,"(35.200090000000003, -89.866749999999996)"
Smith County,Tennessee,19166,39.9,14523,2603,9439,9727,"(36.266719999999999, -85.94999)"
Stewart County,Tennessee,13324,42.8,10278,2223,6655,6669,"(36.483379999999997, -87.833359999999999)"
Sullivan County,Tennessee,156823,43.6,124530,29215,75826,80997,"(36.516770000000001, -82.533209999999997)"
Sumner County,Tennessee,160645,38.6,120015,20262,78389,82256,"(36.499769999999998, -86.44999)"
Tipton County,Tennessee,61081,36.6,44450,6760,29946,31135,"(35.533410000000003, -89.733410000000006)"
Trousdale County,Tennessee,7870,39.5,5935,1065,3912,3958,"(36.383380000000002, -86.166659999999993)"
Unicoi County,Tennessee,18313,44.9,14622,3601,8963,9350,"(36.116779999999999, -82.433189999999996)"
Union County,Tennessee,19109,40.1,14546,2632,9524,9585,"(36.283410000000003, -83.833250000000007)"
Van Buren County,Tennessee,5548,44.5,4391,942,2769,2779,"(35.683399999999999, -85.466639999999998)"
Warren County,Tennessee,39839,39.299999999999997,30140,6025,19653,20186,"(35.683399999999999, -85.783320000000003)"
Washington County,Tennessee,122979,39.299999999999997,98152,18761,60089,62890,"(36.283439999999999, -82.483199999999997)"
Wayne County,Tennessee,17021,40.9,13687,2698,9402,7619,"(35.250360000000001, -87.783360000000002)"
Weakley County,Tennessee,35021,37,27991,5346,17159,17862,"(36.300060000000002, -88.833389999999994)"
White County,Tennessee,25841,42,20036,4534,12640,13201,"(35.950060000000001, -85.466639999999998)"
Williamson County,Tennessee,183182,38.5,129553,17807,89336,93846,"(35.900060000000003, -86.9)"
Wilson County,Tennessee,113993,39.299999999999997,85432,13868,55834,58159,"(36.150060000000003, -86.283320000000003)"
Anderson County,Texas,58458,39.1,46983,7338,35521,22937,"(31.816839999999999, -95.666899999999998)"
Andrews County,Texas,14786,33.4,10474,1663,7368,7418,"(32.300109999999997, -102.63377)"
Angelina County,Texas,86771,36.299999999999997,63565,11843,42515,44256,"(31.25074, -94.566869999999994)"
Aransas County,Texas,23158,49,18635,5602,11485,11673,"(28.100290000000001, -96.983599999999996)"
Archer County,Texas,9054,42.6,6869,1447,4563,4491,"(33.616770000000002, -98.683670000000006)"
Armstrong County,Texas,1901,46.2,1478,394,928,973,"(34.966720000000002, -101.36711)"
Atascosa County,Texas,44911,36.200000000000003,32049,5711,22130,22781,"(28.850249999999999, -98.533630000000002)"
Austin County,Texas,28417,40.700000000000003,21288,4424,14073,14344,"(29.883559999999999, -96.316909999999993)"
Bailey County,Texas,7165,32.5,4949,1009,3621,3544,"(34.066749999999999, -102.8505)"
Bandera County,Texas,20485,48.8,16462,4114,10172,10313,"(29.76689, -99.233649999999997)"
Bastrop County,Texas,74171,38.4,54719,8501,37997,36174,"(30.10022, -97.333600000000004)"
Baylor County,Texas,3726,47,2958,935,1795,1931,"(33.616759999999999, -99.20035)"
Bee County,Texas,31861,35.4,24872,3436,19063,12798,"(28.400279999999999, -97.750829999999993)"
Bell County,Texas,310235,29.6,222118,27003,153464,156771,"(31.050180000000001, -97.466949999999997)"
Bexar County,Texas,1714773,32.799999999999997,1249487,175883,840840,873933,"(29.450230000000001, -98.516959999999997)"
Blanco County,Texas,10497,46.7,8203,1911,5300,5197,"(30.25076, -98.416970000000006)"
Borden County,Texas,641,46,503,133,335,306,"(32.733440000000002, -101.45041000000001)"
Bosque County,Texas,18212,45.2,14041,3844,9053,9159,"(31.90015, -97.650300000000001)"
Bowie County,Texas,92565,37.9,70113,13103,46758,45807,"(33.450119999999998, -94.433530000000005)"
Brazoria County,Texas,313166,35.1,226181,29923,159000,154166,"(29.183579999999999, -95.450220000000002)"
Brazos County,Texas,194851,24.5,155020,14059,98630,96221,"(30.66686, -96.316909999999993)"
Brewster County,Texas,9232,41.5,7355,1531,4636,4596,"(29.83352, -103.25100999999999)"
Briscoe County,Texas,1637,45.7,1275,358,815,822,"(34.5334, -101.2171)"
Brooks County,Texas,7223,37.700000000000003,5217,1226,3579,3644,"(27.033660000000001, -98.233620000000002)"
Brown County,Texas,38106,40.1,28985,6604,18838,19268,"(31.783480000000001, -98.98366)"
Burleson County,Texas,17187,43,13142,3007,8504,8683,"(30.516870000000001, -96.616919999999993)"
Burnet County,Texas,42750,43.2,32829,7945,20989,21761,"(30.783519999999999, -98.183639999999997)"
Caldwell County,Texas,38066,34.799999999999997,28008,4510,19180,18886,"(29.833559999999999, -97.61694)"
Calhoun County,Texas,21381,38.4,15710,3234,10847,10534,"(28.466950000000001, -96.616919999999993)"
Callahan County,Texas,13544,43,10319,2465,6607,6937,"(32.300130000000003, -99.367019999999997)"
Cameron County,Texas,406220,30.6,272021,44891,195394,210826,"(26.11702, -97.516930000000002)"
Camp County,Texas,12401,38.299999999999997,9046,1993,6086,6315,"(32.966790000000003, -94.983549999999994)"
Carson County,Texas,6182,42.4,4595,1061,3042,3140,"(35.416710000000002, -101.36711)"
Cass County,Texas,30464,43.1,23399,5815,14777,15687,"(33.066800000000001, -94.350189999999998)"
Castro County,Texas,8062,33.9,5539,1077,4084,3978,"(34.5334, -102.26714)"
Chambers County,Texas,35096,36.1,25085,3294,17661,17435,"(29.733560000000001, -94.650199999999998)"
Cherokee County,Texas,50845,37.4,37672,7608,25850,24995,"(31.850169999999999, -95.200220000000002)"
Childress County,Texas,7041,33.700000000000003,5533,1065,4121,2920,"(34.533389999999997, -100.21706)"
Clay County,Texas,10752,44.8,8310,1919,5283,5469,"(33.766770000000001, -98.216989999999996)"
Cochran County,Texas,3127,35.700000000000003,2209,465,1535,1592,"(33.600099999999998, -102.83382)"
Coke County,Texas,3320,48.4,2621,862,1626,1694,"(31.883479999999999, -100.53371)"
Coleman County,Texas,8895,46.3,6916,1934,4416,4479,"(31.783480000000001, -99.450339999999997)"
Collin County,Texas,782341,35,557664,60048,384363,397978,"(33.200119999999998, -96.566929999999999)"
Collingsworth County,Texas,3057,38.6,2212,546,1498,1559,"(34.966720000000002, -100.26706)"
Colorado County,Texas,20874,43.6,15906,4040,10347,10527,"(29.616900000000001, -96.533580000000001)"
Comal County,Texas,108472,42.5,82775,16855,53254,55218,"(29.816890000000001, -98.300290000000004)"
Comanche County,Texas,13974,43.3,10594,2923,6885,7089,"(31.950150000000001, -98.566990000000004)"
Concho County,Texas,4087,41.4,3510,560,2793,1294,"(31.333500000000001, -99.850350000000006)"
Cooke County,Texas,38437,39.4,28606,6100,19056,19381,"(33.63344, -97.21696)"
Coryell County,Texas,75388,29.8,54383,5684,36892,38496,"(31.383500000000002, -97.800299999999993)"
Cottle County,Texas,1505,47.1,1155,358,713,792,"(34.083410000000001, -100.26706)"
Crane County,Texas,4375,35.200000000000003,3086,493,2145,2230,"(31.450140000000001, -102.51709)"
Crockett County,Texas,3719,39.1,2725,545,1831,1888,"(30.666840000000001, -101.36706)"
Crosby County,Texas,6059,37.9,4312,1058,2917,3142,"(33.600090000000002, -101.30043000000001)"
Culberson County,Texas,2398,38,1731,354,1167,1231,"(31.450130000000001, -104.58382)"
Dallam County,Texas,6703,32.200000000000003,4700,629,3482,3221,"(36.283360000000002, -102.60047)"
Dallas County,Texas,2368139,32.5,1713876,207972,1171002,1197137,"(32.766800000000003, -96.783609999999996)"
Dawson County,Texas,13833,33.4,10411,1933,7815,6018,"(32.733429999999998, -101.95044)"
Deaf Smith County,Texas,19372,31,13131,2224,9652,9720,"(34.966729999999998, -102.60048999999999)"
Delta County,Texas,5231,44,4046,1037,2563,2668,"(33.38344, -95.700239999999994)"
Denton County,Texas,662614,33,480354,46043,325960,336654,"(33.200119999999998, -97.133619999999993)"
DeWitt County,Texas,20097,42.8,15604,3677,10447,9650,"(29.06692, -97.333600000000004)"
Dickens County,Texas,2444,42.3,1952,481,1383,1061,"(33.616750000000003, -100.76707)"
Dimmit County,Texas,9996,35.700000000000003,6995,1419,4839,5157,"(28.433599999999998, -99.766999999999996)"
Donley County,Texas,3677,42.5,2919,778,1825,1852,"(34.966720000000002, -100.81708999999999)"
Duval County,Texas,11782,37.299999999999997,8707,1891,6077,5705,"(27.666969999999999, -98.516959999999997)"
Eastland County,Texas,18583,42.7,14421,3689,9071,9512,"(32.333469999999998, -98.833669999999998)"
Ector County,Texas,137130,31.4,97322,13954,67686,69444,"(31.866790000000002, -102.55043000000001)"
Edwards County,Texas,2002,47.2,1585,437,1021,981,"(29.96688, -100.30036)"
Ellis County,Texas,149610,35,106295,14945,73870,75740,"(32.350140000000003, -96.800269999999998)"
El Paso County,Texas,800647,31.3,559834,82223,387876,412771,"(31.80011, -106.20054)"
Erath County,Texas,37890,31,29442,4779,18605,19285,"(32.233469999999997, -98.233649999999997)"
Falls County,Texas,17866,39.9,13989,2875,8494,9372,"(31.266839999999998, -96.933599999999998)"
Fannin County,Texas,33915,41,26412,5765,17988,15927,"(33.600099999999998, -96.116919999999993)"
Fayette County,Texas,24554,46.4,19165,5269,12081,12473,"(29.866890000000001, -96.916929999999994)"
Fisher County,Texas,3974,45.7,3076,884,1958,2016,"(32.733440000000002, -100.41705)"
Floyd County,Texas,6446,38.5,4584,1145,3176,3270,"(34.066740000000003, -101.30043000000001)"
Foard County,Texas,1336,46.7,1058,319,637,699,"(33.966749999999998, -99.767039999999994)"
Fort Bend County,Texas,585375,35,411540,42758,287368,298007,"(29.550239999999999, -95.783559999999994)"
Franklin County,Texas,10605,42.1,8003,1981,5215,5390,"(33.183450000000001, -95.233549999999994)"
Freestone County,Texas,19816,40.9,15186,3285,10437,9379,"(31.70017, -96.266919999999999)"
Frio County,Texas,17217,32.299999999999997,12958,1936,10032,7185,"(28.86692, -99.100309999999993)"
Gaines County,Texas,17526,28.4,11420,1577,8798,8728,"(32.733440000000002, -102.63379999999999)"
Galveston County,Texas,291309,37.200000000000003,217142,32804,144234,147075,"(29.366900000000001, -94.96687)"
Garza County,Texas,6461,33.700000000000003,5185,702,4092,2369,"(33.166759999999996, -101.30041)"
Gillespie County,Texas,24837,49.6,19796,6586,11968,12869,"(30.316870000000002, -98.950320000000005)"
Glasscock County,Texas,1226,38.200000000000003,874,160,649,577,"(31.866800000000001, -101.53373000000001)"
Goliad County,Texas,7210,45.7,5562,1372,3596,3614,"(28.650269999999999, -97.433599999999998)"
Gonzales County,Texas,19807,37.200000000000003,14439,2992,9959,9848,"(29.450240000000001, -97.483599999999996)"
Gray County,Texas,22535,38.799999999999997,16964,3612,11703,10832,"(35.416699999999999, -100.80200000000001)"
Grayson County,Texas,120877,39.5,91745,18775,58917,61960,"(33.616770000000002, -96.683599999999998)"
Gregg County,Texas,121730,35.299999999999997,90709,16476,59468,62262,"(32.51681, -94.816879999999998)"
Grimes County,Texas,26604,40,20545,3672,14487,12117,"(30.533529999999999, -95.966899999999995)"
Guadalupe County,Texas,131533,36.4,95129,15297,64762,66771,"(29.5669, -97.966949999999997)"
Hale County,Texas,36273,32.200000000000003,25839,4435,18737,17536,"(34.066740000000003, -101.83378999999999)"
Hall County,Texas,3353,43.5,2486,759,1657,1696,"(34.533389999999997, -100.68374)"
Hamilton County,Texas,8517,46.7,6701,2105,4195,4322,"(31.716819999999998, -98.083640000000003)"
Hansford County,Texas,5613,35.5,3910,766,2803,2810,"(36.283360000000002, -101.36709999999999)"
Hardeman County,Texas,4139,42.7,3120,808,2051,2088,"(34.283410000000003, -99.733699999999999)"
Hardin County,Texas,54635,38.1,40525,7382,26942,27693,"(30.316880000000001, -94.366860000000003)"
Harris County,Texas,4092459,32.200000000000003,2944624,333487,2037405,2055054,"(29.833559999999999, -95.400220000000004)"
Harrison County,Texas,65631,37.4,48650,8716,32224,33407,"(32.550150000000002, -94.366860000000003)"
Hartley County,Texas,6062,39,4693,757,3700,2362,"(35.85004, -102.60048)"
Haskell County,Texas,5899,44.6,4671,1286,3104,2795,"(33.16677, -99.733699999999999)"
Hays County,Texas,157107,30.4,118346,13285,78255,78852,"(30.05021, -98.033619999999999)"
Hemphill County,Texas,3807,35.9,2691,492,1928,1879,"(35.85004, -100.26707)"
Henderson County,Texas,78532,42.8,60690,15032,38468,40064,"(32.200150000000001, -95.833579999999998)"
Hidalgo County,Texas,774769,28.3,506285,72248,376944,397825,"(26.333680000000001, -98.200289999999995)"
Hill County,Texas,35089,41,26569,6418,17208,17881,"(32.016820000000003, -97.133619999999993)"
Hockley County,Texas,22935,33.6,16708,2927,11297,11638,"(33.600090000000002, -102.35046)"
Hood County,Texas,51182,45.9,40280,10892,25181,26001,"(32.43347, -97.866979999999998)"
Hopkins County,Texas,35161,38.799999999999997,26167,5448,17421,17740,"(33.150109999999998, -95.583569999999995)"
Houston County,Texas,23732,43.6,18806,4562,12769,10963,"(31.33351, -95.416889999999995)"
Howard County,Texas,35012,38.5,27155,4615,19720,15292,"(32.30012, -101.4504)"
Hudspeth County,Texas,3476,36.5,2429,472,1750,1726,"(31.46679, -105.30051)"
Hunt County,Texas,86129,37.799999999999997,64710,12001,42700,43429,"(33.150120000000001, -96.066919999999996)"
Hutchinson County,Texas,22150,37.799999999999997,16322,3266,11077,11073,"(35.85004, -101.36711)"
Irion County,Texas,1599,45.1,1231,291,807,792,"(31.31683, -100.98372000000001)"
Jack County,Texas,9044,39.200000000000003,7052,1350,5030,4014,"(33.21678, -98.166989999999998)"
Jackson County,Texas,14075,39.4,10496,2313,6947,7128,"(28.933599999999998, -96.550250000000005)"
Jasper County,Texas,35710,40.5,26815,5932,17543,18167,"(30.733540000000001, -94.016850000000005)"
Jeff Davis County,Texas,2342,52,1878,543,1187,1155,"(30.700150000000001, -104.0838)"
Jefferson County,Texas,252273,36,191875,32002,128946,123327,"(29.88355, -94.150180000000006)"
Jim Hogg County,Texas,5300,35.6,3762,789,2616,2684,"(27.033660000000001, -98.700299999999999)"
Jim Wells County,Texas,40838,34.9,29080,5332,20107,20731,"(27.766970000000001, -98.100279999999998)"
Johnson County,Texas,150934,36.299999999999997,109785,17331,75519,75415,"(32.383479999999999, -97.366960000000006)"
Jones County,Texas,20202,39,16468,2764,12383,7819,"(32.75067, -99.883709999999994)"
Karnes County,Texas,14824,37.200000000000003,11862,2068,8842,5982,"(28.883590000000002, -97.850279999999998)"
Kaufman County,Texas,103350,35.4,73596,10622,50811,52539,"(32.60013, -96.300259999999994)"
Kendall County,Texas,33410,44.1,25311,5584,16299,17111,"(29.93355, -98.716970000000003)"
Kenedy County,Texas,416,41.3,314,59,212,204,"(26.950330000000001, -97.666939999999997)"
Kent County,Texas,808,48.4,623,208,392,416,"(33.166759999999996, -100.76706)"
Kerr County,Texas,49625,47.3,39611,12314,24068,25557,"(30.05021, -99.300319999999999)"
Kimble County,Texas,4607,48.6,3668,1051,2281,2326,"(30.46686, -99.767009999999999)"
King County,Texas,286,43.4,218,38,141,145,"(33.616750000000003, -100.35039)"
Kinney County,Texas,3598,45.3,2874,874,1955,1643,"(29.333570000000002, -100.41701999999999)"
Kleberg County,Texas,32061,29,24011,3681,16337,15724,"(27.43365, -97.716939999999994)"
Knox County,Texas,3719,41.6,2777,790,1835,1884,"(33.600090000000002, -99.733699999999999)"
Lamar County,Texas,49793,39.700000000000003,37698,8276,24044,25749,"(33.66677, -95.583569999999995)"
Lamb County,Texas,13977,36.299999999999997,9885,2227,6964,7013,"(34.066760000000002, -102.35046)"
Lampasas County,Texas,19677,41,14801,3101,9705,9972,"(31.216830000000002, -98.233639999999994)"
La Salle County,Texas,6886,30,5392,857,4089,2797,"(28.350269999999998, -99.100309999999993)"
Lavaca County,Texas,19263,45.2,14815,4089,9416,9847,"(29.383579999999998, -96.95026)"
Lee County,Texas,16612,39.799999999999997,12267,2622,8410,8202,"(30.283550000000002, -96.95026)"
Leon County,Texas,16801,45.7,13052,3615,8385,8416,"(31.300180000000001, -95.98357)"
Liberty County,Texas,75643,36.4,56276,8498,37190,38453,"(30.13355, -94.800200000000004)"
Limestone County,Texas,23384,39,17867,3771,12122,11262,"(31.550170000000001, -96.566929999999999)"
Lipscomb County,Texas,3302,37,2391,484,1662,1640,"(36.252899999999997, -100.28619999999999)"
Live Oak County,Texas,11531,43.8,9177,2217,6195,5336,"(28.316949999999999, -98.100279999999998)"
Llano County,Texas,19301,55,16224,6002,9329,9972,"(30.70018, -98.666979999999995)"
Loving County,Texas,82,52.7,73,12,46,36,"(31.733460000000001, -103.55046)"
Lubbock County,Texas,278831,30.4,210969,30622,137786,141045,"(33.600079999999998, -101.83378)"
Lynn County,Texas,5915,39.4,4270,933,2947,2968,"(33.166759999999996, -101.83377)"
McCulloch County,Texas,8283,43.5,6244,1645,4057,4226,"(31.183499999999999, -99.35033)"
McLennan County,Texas,234906,32.700000000000003,175161,29259,114169,120737,"(31.550170000000001, -97.183620000000005)"
McMullen County,Texas,707,49.8,588,187,367,340,"(28.350280000000001, -98.566959999999995)"
Madison County,Texas,13664,34.5,10664,1901,7873,5791,"(30.96686, -95.93356)"
Marion County,Texas,10546,48.4,8537,2270,5171,5375,"(32.800139999999999, -94.350189999999998)"
Martin County,Texas,4799,34.700000000000003,3343,591,2411,2388,"(32.300109999999997, -101.95041999999999)"
Mason County,Texas,4012,49.3,3161,979,1978,2034,"(30.733509999999999, -99.233670000000004)"
Matagorda County,Texas,36702,38.4,27031,5249,18363,18339,"(28.850259999999999, -95.950239999999994)"
Maverick County,Texas,54258,30,35935,5727,26451,27807,"(28.766919999999999, -100.35035000000001)"
Medina County,Texas,46006,38.6,34141,6210,23656,22350,"(29.366900000000001, -99.100309999999993)"
Menard County,Texas,2242,50.4,1803,602,1133,1109,"(30.86684, -99.850350000000006)"
Midland County,Texas,136872,33.5,99343,15114,67242,69630,"(31.866790000000002, -102.05041)"
Milam County,Texas,24757,40.5,18205,4305,12225,12532,"(30.800190000000001, -96.95026)"
Mills County,Texas,4936,45.7,3739,1158,2445,2491,"(31.483499999999999, -98.583650000000006)"
Mitchell County,Texas,9403,35.4,7583,1233,5746,3657,"(32.30012, -100.93371999999999)"
Montague County,Texas,19719,43.6,15192,3880,9665,10054,"(33.683439999999997, -97.716970000000003)"
Montgomery County,Texas,455746,36.1,329767,47404,225911,229835,"(30.316880000000001, -95.466880000000003)"
Moore County,Texas,21904,30.7,14905,2107,11317,10587,"(35.85004, -101.90046)"
Morris County,Texas,12934,42.2,9921,2506,6239,6695,"(33.116790000000002, -94.75076)"
Motley County,Texas,1210,49,946,328,613,597,"(34.066740000000003, -100.78373999999999)"
Nacogdoches County,Texas,64524,29.8,49463,7622,30800,33724,"(31.600180000000002, -94.633539999999996)"
Navarro County,Texas,47735,37.1,34812,6863,23657,24078,"(32.050150000000002, -96.466930000000005)"
Newton County,Texas,14445,40.700000000000003,11092,2342,7445,7000,"(30.766870000000001, -93.766850000000005)"
Nolan County,Texas,15216,39,11281,2519,7561,7655,"(32.30012, -100.41705)"
Nueces County,Texas,340223,35.1,251968,40913,167038,173185,"(27.733640000000001, -97.633610000000004)"
Ochiltree County,Texas,10223,31.8,6992,1056,5237,4986,"(36.283369999999998, -100.81708999999999)"
Oldham County,Texas,2052,34.4,1354,255,1035,1017,"(35.416719999999998, -102.60048999999999)"
Orange County,Texas,81837,38.6,61330,11473,40708,41129,"(30.13354, -93.900170000000003)"
Palo Pinto County,Texas,28111,40.299999999999997,21080,4582,13811,14300,"(32.750680000000003, -98.300330000000002)"
Panola County,Texas,23796,38.9,17926,3705,11808,11988,"(32.166829999999997, -94.300200000000004)"
Parker County,Texas,116927,38.9,87058,14283,59292,57635,"(32.766800000000003, -97.800309999999996)"
Parmer County,Texas,10269,31.9,7055,1224,5259,5010,"(34.5334, -102.8005)"
Pecos County,Texas,15507,36.6,11685,1821,8742,6765,"(30.750710000000002, -102.75099)"
Polk County,Texas,45413,42.9,35836,8646,24288,21125,"(30.783529999999999, -94.850210000000004)"
Potter County,Texas,121073,33,87420,13142,61919,59154,"(35.416719999999998, -101.90046)"
Presidio County,Texas,7818,38.5,5554,1389,3818,4000,"(29.916840000000001, -104.25103)"
Rains County,Texas,10914,45.8,8551,2223,5485,5429,"(32.866790000000002, -95.800240000000002)"
Randall County,Texas,120725,35.299999999999997,90622,15079,58737,61988,"(34.966720000000002, -101.90047)"
Reagan County,Texas,3367,33.5,2357,349,1748,1619,"(31.366810000000001, -101.53373000000001)"
Real County,Texas,3309,50.5,2649,853,1638,1671,"(29.816890000000001, -99.833669999999998)"
Red River County,Texas,12860,45.1,10113,2712,6266,6594,"(33.616779999999999, -95.033550000000005)"
Reeves County,Texas,13783,35.4,10641,1654,8281,5502,"(31.300139999999999, -103.66712)"
Refugio County,Texas,7383,43,5602,1440,3669,3714,"(28.33362, -97.166939999999997)"
Roberts County,Texas,929,41.3,693,149,469,460,"(35.85004, -100.81708999999999)"
Robertson County,Texas,16622,40.4,12409,2770,8230,8392,"(31.033519999999999, -96.500799999999998)"
Rockwall County,Texas,78337,35.9,54830,7540,38516,39821,"(32.900120000000001, -96.400260000000003)"
Runnels County,Texas,10501,42.3,7869,2044,5197,5304,"(31.833480000000002, -99.967029999999994)"
Rusk County,Texas,53330,38.6,40951,7487,28075,25255,"(32.11683, -94.783550000000005)"
Sabine County,Texas,10834,50.5,8714,2901,5301,5533,"(31.350180000000002, -93.850189999999998)"
San Augustine County,Texas,8865,47.1,6999,2044,4360,4505,"(31.400179999999999, -94.16686)"
San Jacinto County,Texas,26384,43,20058,4572,13205,13179,"(30.566870000000002, -95.166880000000006)"
San Patricio County,Texas,64804,36.1,46529,8361,32163,32641,"(28.016960000000001, -97.516940000000005)"
San Saba County,Texas,6131,40.6,4846,1177,3366,2765,"(31.150169999999999, -98.850319999999996)"
Schleicher County,Texas,3461,33.700000000000003,2358,440,1726,1735,"(30.900169999999999, -100.55037)"
Scurry County,Texas,16921,36.799999999999997,12687,2383,9028,7893,"(32.733440000000002, -100.93373)"
Shackelford County,Texas,3378,42.9,2544,589,1632,1746,"(32.75067, -99.350359999999995)"
Shelby County,Texas,25448,37.6,18721,3988,12591,12857,"(31.800170000000001, -94.150199999999998)"
Sherman County,Texas,3034,36.799999999999997,2118,405,1548,1486,"(36.283360000000002, -101.90045000000001)"
Smith County,Texas,209714,35.6,155918,29851,101425,108289,"(32.366819999999997, -95.233559999999997)"
Somervell County,Texas,8490,40.299999999999997,6244,1258,4182,4308,"(32.23348, -97.766970000000001)"
Starr County,Texas,60968,29,40290,6285,29440,31528,"(26.567, -98.766970000000001)"
Stephens County,Texas,9630,40.1,7325,1748,4975,4655,"(32.750680000000003, -98.850340000000003)"
Sterling County,Texas,1143,41.8,864,187,576,567,"(31.833469999999998, -101.05038999999999)"
Stonewall County,Texas,1490,46.3,1151,353,717,773,"(33.166759999999996, -100.35039)"
Sutton County,Texas,4128,38.700000000000003,2994,573,2029,2099,"(30.50074, -100.55037)"
Swisher County,Texas,7854,37,5802,1342,4136,3718,"(34.533389999999997, -101.73379)"
Tarrant County,Texas,1809034,33.4,1301973,161385,887235,921799,"(32.766800000000003, -97.300290000000004)"
Taylor County,Texas,131506,32.799999999999997,99348,17354,64028,67478,"(32.300130000000003, -99.833699999999993)"
Terrell County,Texas,984,44.5,766,205,509,475,"(30.200189999999999, -102.16708)"
Terry County,Texas,12651,35.1,9372,1827,6717,5934,"(33.166759999999996, -102.35046)"
Throckmorton County,Texas,1641,46.6,1275,403,807,834,"(33.16677, -99.20035)"
Titus County,Texas,32334,32.5,22451,3731,15976,16358,"(33.233449999999998, -94.983549999999994)"
Tom Green County,Texas,110224,34.299999999999997,84290,15265,53976,56248,"(31.40016, -100.46704)"
Travis County,Texas,1024266,31.9,779229,74759,516637,507629,"(30.333539999999999, -97.800290000000004)"
Trinity County,Texas,14585,47.3,11544,3272,7100,7485,"(31.100180000000002, -95.216880000000003)"
Tyler County,Texas,21766,42.1,17414,4129,11731,10035,"(30.783529999999999, -94.383529999999993)"
Upshur County,Texas,39309,40.5,29587,6191,19462,19847,"(32.733469999999997, -94.950220000000002)"
Upton County,Texas,3355,36.5,2440,493,1675,1680,"(31.366810000000001, -102.05041)"
Uvalde County,Texas,26405,35.299999999999997,18772,3896,12909,13496,"(29.366900000000001, -99.766999999999996)"
Val Verde County,Texas,48879,32.299999999999997,34315,6052,24519,24360,"(29.833539999999999, -101.08372)"
Van Zandt County,Texas,52579,42.1,39929,9447,25863,26716,"(32.566800000000001, -95.850239999999999)"
Victoria County,Texas,86793,36.4,63616,11664,42349,44444,"(28.7836, -96.95026)"
Walker County,Texas,67861,34.5,56543,6980,40007,27854,"(30.733529999999998, -95.566890000000001)"
Waller County,Texas,43205,31.7,32549,4396,21395,21810,"(30.000779999999999, -96.000789999999995)"
Ward County,Texas,10658,37,7738,1575,5151,5507,"(31.5168, -103.0671)"
Washington County,Texas,33718,41.6,26268,6199,16580,17138,"(30.233550000000001, -96.400239999999997)"
Webb County,Texas,250304,27.8,162146,19507,121488,128816,"(27.66696, -99.333650000000006)"
Wharton County,Texas,41280,37.200000000000003,30208,6019,20291,20989,"(29.283580000000001, -96.216909999999999)"
Wheeler County,Texas,5410,40.200000000000003,4039,995,2661,2749,"(35.416710000000002, -100.26707)"
Wichita County,Texas,131500,33.9,101091,17177,67438,64062,"(33.966760000000001, -98.717010000000002)"
Wilbarger County,Texas,13535,38,10068,2108,6736,6799,"(34.066749999999999, -99.267020000000002)"
Willacy County,Texas,22134,32.1,16203,2587,12030,10104,"(26.467009999999998, -97.633600000000001)"
Williamson County,Texas,422679,34.200000000000003,301227,37681,208032,214647,"(30.650189999999998, -97.600279999999998)"
Wilson County,Texas,42918,40,31584,5412,21372,21546,"(29.166910000000001, -98.066950000000006)"
Winkler County,Texas,7110,34.700000000000003,5001,840,3550,3560,"(31.85013, -103.03377)"
Wise County,Texas,59127,38.4,43724,7279,29803,29324,"(33.200119999999998, -97.666970000000006)"
Wood County,Texas,41964,47.5,33436,10148,20622,21342,"(32.783459999999998, -95.383560000000003)"
Yoakum County,Texas,7879,32.799999999999997,5378,895,3899,3980,"(33.16677, -102.83382)"
Young County,Texas,18550,41.8,14091,3422,9148,9402,"(33.166780000000003, -98.683670000000006)"
Zapata County,Texas,14018,28.3,9213,1460,7044,6974,"(26.983650000000001, -99.166979999999995)"
Zavala County,Texas,11677,30.8,8017,1408,5760,5917,"(28.850249999999999, -99.766999999999996)"
Beaver County,Utah,6629,31.9,4385,832,3410,3219,"(38.374409999999997, -113.12635)"
Box Elder County,Utah,49975,30.6,32997,5563,25185,24790,"(41.500480000000003, -112.87636999999999)"
Cache County,Utah,112656,25.5,77017,8694,55999,56657,"(41.749380000000002, -111.75022)"
Carbon County,Utah,21403,34.4,15681,2903,10615,10788,"(39.741070000000001, -110.50127000000001)"
Daggett County,Utah,1059,42.8,816,201,597,462,"(40.874400000000001, -109.37625)"
Davis County,Utah,306479,29.2,201140,24992,153891,152588,"(41.000500000000002, -112.00133)"
Duchesne County,Utah,18607,29.7,12298,1984,9455,9152,"(40.250509999999998, -110.37627000000001)"
Emery County,Utah,10976,32.799999999999997,7488,1368,5589,5387,"(38.99109, -110.62627000000001)"
Garfield County,Utah,5172,39,3793,831,2674,2498,"(37.750540000000001, -111.50127999999999)"
Grand County,Utah,9225,39.9,7107,1251,4646,4579,"(38.875529999999998, -109.50123000000001)"
Iron County,Utah,46163,26.8,32219,4533,22953,23210,"(37.750529999999998, -113.12634)"
Juab County,Utah,10246,29.3,6409,1043,5228,5018,"(37.74944, -112.75055999999999)"
Kane County,Utah,7125,44.5,5396,1388,3521,3604,"(37.374429999999997, -111.87629)"
Millard County,Utah,12503,33.700000000000003,8442,1770,6367,6136,"(39.125509999999998, -113.12524000000001)"
Morgan County,Utah,9469,32,6120,997,4771,4698,"(41.000500000000002, -111.75021)"
Piute County,Utah,1556,40.5,1088,332,796,760,"(38.250540000000001, -112.12520000000001)"
Rich County,Utah,2264,34.700000000000003,1560,343,1170,1094,"(41.625500000000002, -111.25020000000001)"
Salt Lake County,Utah,1029655,30.8,729874,89367,517881,511774,"(40.625500000000002, -111.87632000000001)"
San Juan County,Utah,14746,29.9,9729,1600,7403,7343,"(37.750549999999997, -109.50123000000001)"
Sanpete County,Utah,27822,28.4,19481,3197,14558,13264,"(39.250520000000002, -111.5013)"
Sevier County,Utah,20802,32.799999999999997,14202,3016,10494,10308,"(38.625529999999998, -111.6263)"
Summit County,Utah,36324,37.1,26254,2768,18724,17600,"(40.874389999999998, -110.87627999999999)"
Tooele County,Utah,58218,29.6,37200,4379,29327,28891,"(40.375489999999999, -113.12526)"
Uintah County,Utah,32588,29.1,21731,2997,16569,16019,"(40.249409999999997, -109.37624)"
Utah County,Utah,516564,24.6,334587,33457,258761,257803,"(40.124400000000001, -111.62631)"
Wasatch County,Utah,23530,31.6,15550,2017,11962,11568,"(40.375509999999998, -111.12627999999999)"
Washington County,Utah,138115,32.5,96429,23826,68292,69823,"(37.250540000000001, -113.25134)"
Wayne County,Utah,2778,37.1,1940,425,1404,1374,"(38.374429999999997, -110.87627000000001)"
Weber County,Utah,231236,30.7,161925,23388,116075,115161,"(41.250500000000002, -111.75133)"
Addison County,Vermont,36821,41.3,29319,5102,18364,18457,"(44.050060000000002, -73.116230000000002)"
Bennington County,Vermont,37125,45.1,29522,6995,17954,19171,"(43.033410000000003, -73.099549999999994)"
Caledonia County,Vermont,31227,42.1,24434,4793,15509,15718,"(44.450060000000001, -72.099540000000005)"
Chittenden County,Vermont,156545,36.200000000000003,125232,17685,76309,80236,"(44.450049999999997, -73.049570000000003)"
Essex County,Vermont,6306,47.4,5109,1220,3188,3118,"(44.683390000000003, -71.75009)"
Franklin County,Vermont,47746,39.6,35939,5808,23688,24058,"(44.850050000000003, -72.866249999999994)"
Grand Isle County,Vermont,6970,45.5,5553,979,3478,3492,"(44.81671, -73.299580000000006)"
Lamoille County,Vermont,24475,39.700000000000003,19008,3264,12244,12231,"(44.583379999999998, -72.632890000000003)"
Orange County,Vermont,28936,43.8,22887,4276,14421,14515,"(44.000619999999998, -72.449539999999999)"
Orleans County,Vermont,27231,43.7,21435,4824,13611,13620,"(44.81671, -72.232879999999994)"
Rutland County,Vermont,61642,44.3,49760,10257,30385,31257,"(43.616729999999997, -73.016220000000004)"
Washington County,Vermont,59534,42.3,47214,8617,29412,30122,"(44.116729999999997, -72.616219999999998)"
Windham County,Vermont,44513,44.9,35675,7167,21869,22644,"(42.983409999999999, -72.732870000000005)"
Windsor County,Vermont,56670,45.8,45421,10091,27774,28896,"(43.550069999999998, -72.566209999999998)"
Accomack County,Virginia,33164,44.7,26239,6336,16154,17010,"(37.750129999999999, -75.666319999999999)"
Albemarle County,Virginia,98970,38.200000000000003,77685,14124,47609,51361,"(38.033470000000001, -78.54974)"
Alleghany County,Virginia,16250,45.8,12800,3305,7954,8296,"(37.783459999999998, -80.000339999999994)"
Amelia County,Virginia,12690,42.7,9868,1999,6227,6463,"(37.350149999999999, -78.016390000000001)"
Amherst County,Virginia,32353,42,25413,5330,15452,16901,"(37.616799999999998, -79.250309999999999)"
Appomattox County,Virginia,14973,42.8,11648,2607,7290,7683,"(37.366810000000001, -78.816400000000002)"
Arlington County,Virginia,207627,33.4,175001,18054,103501,104126,"(38.866779999999999, -77.099699999999999)"
Augusta County,Virginia,73750,42.9,57995,11839,37412,36338,"(38.166800000000002, -79.116420000000005)"
Bath County,Virginia,4731,47.5,3927,1052,2390,2341,"(38.066789999999997, -79.733099999999993)"
Bedford County,Virginia,68676,44.3,53371,11147,34057,34619,"(37.300139999999999, -79.566419999999994)"
Bland County,Virginia,6824,43.6,5604,1185,3765,3059,"(37.150120000000001, -81.133150000000001)"
Botetourt County,Virginia,33148,44.9,25714,5425,16417,16731,"(37.566800000000001, -79.783100000000005)"
Brunswick County,Virginia,17434,41.3,14067,2882,9150,8284,"(36.750979999999998, -77.849720000000005)"
Buchanan County,Virginia,24098,43.8,19585,3868,12310,11788,"(37.25067, -82.033190000000005)"
Buckingham County,Virginia,17146,41.7,13849,2452,9493,7653,"(37.550150000000002, -78.566389999999998)"
Campbell County,Virginia,54842,41.1,42798,8685,26688,28154,"(37.23348, -79.099739999999997)"
Caroline County,Virginia,28545,38.9,21701,3744,14052,14493,"(38.033470000000001, -77.349699999999999)"
Carroll County,Virginia,30042,44.7,23824,5837,14821,15221,"(36.733460000000001, -80.699789999999993)"
Charles City County,Virginia,7256,46.6,5955,1214,3567,3689,"(37.366810000000001, -77.066360000000003)"
Charlotte County,Virginia,12586,43.7,9685,2351,6180,6406,"(37.000149999999998, -78.683059999999998)"
Chesterfield County,Virginia,316236,37.6,233721,32878,152399,163837,"(37.383479999999999, -77.599710000000002)"
Clarke County,Virginia,14034,44.9,10813,2287,6989,7045,"(39.116770000000002, -77.966390000000004)"
Craig County,Virginia,5190,44.8,4079,886,2565,2625,"(37.483460000000001, -80.183109999999999)"
Culpeper County,Virginia,46689,38.200000000000003,34604,5698,23684,23005,"(38.500399999999999, -77.966390000000004)"
Cumberland County,Virginia,10052,41.6,7765,1617,4870,5182,"(37.500430000000001, -78.25)"
Dickenson County,Virginia,15903,43,12580,2663,7950,7953,"(37.13344, -82.349869999999996)"
Dinwiddie County,Virginia,28001,40.700000000000003,21622,3826,13736,14265,"(37.06682, -77.633049999999997)"
Essex County,Virginia,11151,43.2,8700,1936,5274,5877,"(37.950139999999998, -76.949690000000004)"
Fairfax County,Virginia,1081726,37.299999999999997,819078,106290,534310,547416,"(38.850110000000001, -77.349710000000002)"
Fauquier County,Virginia,65203,41.3,48758,8289,32158,33045,"(38.733449999999998, -77.816379999999995)"
Floyd County,Virginia,15279,43.6,11932,2686,7667,7612,"(36.916800000000002, -80.399780000000007)"
Fluvanna County,Virginia,25691,41.1,19773,4022,11804,13887,"(37.850140000000003, -78.266390000000001)"
Franklin County,Virginia,56159,44.1,44482,9877,27706,28453,"(37.002360000000003, -79.866420000000005)"
Frederick County,Virginia,78305,39.1,58630,9954,38916,39389,"(39.216769999999997, -78.249719999999996)"
Giles County,Virginia,17286,43.2,13541,3116,8473,8813,"(37.316789999999997, -80.683120000000002)"
Gloucester County,Virginia,36858,42.6,28718,5410,18239,18619,"(37.416809999999998, -76.549670000000006)"
Goochland County,Virginia,21717,45.2,17317,3237,10764,10953,"(37.73348, -77.916380000000004)"
Grayson County,Virginia,15533,46.7,12583,3259,7611,7922,"(36.650120000000001, -81.216480000000004)"
Greene County,Virginia,18403,39.299999999999997,13812,2345,9057,9346,"(38.300130000000003, -78.466399999999993)"
Greensville County,Virginia,12243,40.9,10237,1537,7668,4575,"(36.683480000000003, -77.566370000000006)"
Halifax County,Virginia,36241,44.7,28258,7019,17274,18967,"(36.750419999999998, -78.933070000000001)"
Hanover County,Virginia,99863,41,74865,13104,49060,50803,"(37.750140000000002, -77.483040000000003)"
Henrico County,Virginia,306935,37.5,232563,37924,144167,162768,"(37.550150000000002, -77.366370000000003)"
Henry County,Virginia,54151,44.7,43043,10656,26082,28069,"(36.666800000000002, -79.883089999999996)"
Highland County,Virginia,2321,52.5,1975,579,1159,1162,"(38.366790000000002, -79.366429999999994)"
Isle of Wight County,Virginia,35270,43.8,27239,5165,17177,18093,"(36.883479999999999, -76.699680000000001)"
James City County,Virginia,67009,44.9,52624,13870,32346,34663,"(37.300150000000002, -76.766350000000003)"
King and Queen County,Virginia,6945,45.2,5503,1203,3454,3491,"(37.733469999999997, -76.899690000000007)"
King George County,Virginia,23584,36.6,17044,2397,11851,11733,"(38.266800000000003, -77.149699999999996)"
King William County,Virginia,15935,39.4,12000,1970,7759,8176,"(37.683480000000003, -77.083029999999994)"
Lancaster County,Virginia,11391,54.1,9560,3554,5352,6039,"(37.733469999999997, -76.433000000000007)"
Lee County,Virginia,25587,41.2,20410,4104,13352,12235,"(36.683419999999998, -83.133229999999998)"
Loudoun County,Virginia,312311,34.799999999999997,216877,20425,154078,158233,"(39.083440000000003, -77.649709999999999)"
Louisa County,Virginia,33153,42.6,25815,4796,16340,16813,"(37.983469999999997, -77.966390000000004)"
Lunenburg County,Virginia,12914,43.8,10420,2221,6857,6057,"(36.950150000000001, -78.250280000000004)"
Madison County,Virginia,13308,44.1,10338,2330,6488,6820,"(38.416789999999999, -78.266390000000001)"
Mathews County,Virginia,8978,50.1,7344,2290,4363,4615,"(37.43347, -76.366330000000005)"
Mecklenburg County,Virginia,32727,45.8,26351,6784,16225,16502,"(36.700139999999998, -78.349720000000005)"
Middlesex County,Virginia,10959,51,9198,2760,5466,5493,"(37.600140000000003, -76.566339999999997)"
Montgomery County,Virginia,94392,26.6,79277,9228,48823,45569,"(37.166800000000002, -80.383099999999999)"
Nelson County,Virginia,15020,47.6,12128,2988,7302,7718,"(37.783479999999997, -78.783079999999998)"
New Kent County,Virginia,18429,42.4,14328,2226,9373,9056,"(37.48348, -76.999690000000001)"
Northampton County,Virginia,12389,47.8,9953,2781,5929,6460,"(37.350140000000003, -75.932990000000004)"
Northumberland County,Virginia,12330,53.6,10309,3713,6009,6321,"(37.883470000000003, -76.416340000000005)"
Nottoway County,Virginia,15853,41.4,12590,2703,8371,7482,"(37.133479999999999, -78.066389999999998)"
Orange County,Virginia,33481,42.6,25819,6063,16422,17059,"(38.250689999999999, -78.033050000000003)"
Page County,Virginia,24042,43,18849,4248,11836,12206,"(38.633450000000003, -78.466399999999993)"
Patrick County,Virginia,18490,46.8,14924,3974,9090,9400,"(36.666800000000002, -80.283109999999994)"
Pittsylvania County,Virginia,63506,44.2,50021,10916,31226,32280,"(36.816809999999997, -79.399749999999997)"
Powhatan County,Virginia,28046,41.6,21569,3407,15114,12932,"(37.56682, -77.916390000000007)"
Prince Edward County,Virginia,23368,30.9,19311,3251,11621,11747,"(37.200150000000001, -78.449719999999999)"
Prince George County,Virginia,35725,38,27673,3712,19510,16215,"(37.200150000000001, -77.233029999999999)"
Prince William County,Virginia,402002,33.5,285827,27220,199677,202325,"(38.700119999999998, -77.483040000000003)"
Pulaski County,Virginia,34872,44.1,28071,6231,17239,17633,"(37.066789999999997, -80.716459999999998)"
Rappahannock County,Virginia,7373,47.5,5908,1408,3685,3688,"(38.666789999999999, -78.149720000000002)"
Richmond County,Virginia,9254,43.5,7663,1682,5231,4023,"(37.950130000000001, -76.733009999999993)"
Roanoke County,Virginia,92376,43.3,72263,15912,44079,48297,"(37.283470000000001, -80.049760000000006)"
Rockbridge County,Virginia,22307,46.5,18043,4620,10996,11311,"(37.800130000000003, -79.433090000000007)"
Rockingham County,Virginia,76314,40.4,58242,11964,37477,38837,"(38.51679, -78.883080000000007)"
Russell County,Virginia,28897,43,22992,4740,14155,14742,"(36.933439999999997, -82.083190000000002)"
Scott County,Virginia,23177,44.7,18701,4570,11498,11679,"(36.700099999999999, -82.583209999999994)"
Shenandoah County,Virginia,41993,43.1,32764,7768,20529,21464,"(38.866779999999999, -78.599739999999997)"
Smyth County,Virginia,32208,43.1,25491,5846,15705,16503,"(36.850119999999997, -81.516499999999994)"
Southampton County,Virginia,18570,44.3,14652,2828,9666,8904,"(36.73348, -77.099689999999995)"
Spotsylvania County,Virginia,122397,36.4,88354,12114,59925,62472,"(38.18347, -77.649709999999999)"
Stafford County,Virginia,128961,34.6,91764,9464,64822,64139,"(38.416789999999999, -77.466369999999998)"
Surry County,Virginia,7058,45,5571,1121,3484,3574,"(37.116819999999997, -76.899680000000004)"
Sussex County,Virginia,12087,40.6,10059,1752,7083,5004,"(36.933480000000003, -77.249690000000001)"
Tazewell County,Virginia,45078,43.2,35903,7757,22289,22789,"(37.100119999999997, -81.566500000000005)"
Warren County,Virginia,37575,39.700000000000003,28495,4780,18684,18891,"(38.933439999999997, -78.183059999999998)"
Washington County,Virginia,54876,43.7,44122,9738,27070,27806,"(36.71678, -81.96651)"
Westmoreland County,Virginia,17454,46.6,13961,3645,8511,8943,"(38.116799999999998, -76.783019999999993)"
Wise County,Virginia,41452,39,32846,5865,21431,20021,"(36.966769999999997, -82.599879999999999)"
Wythe County,Virginia,29235,43.2,23125,5212,14303,14932,"(36.916789999999999, -81.049809999999994)"
York County,Virginia,65464,39.4,48188,7934,32001,33463,"(37.23348, -76.549670000000006)"
Alexandria city,Virginia,139966,35.6,115996,12806,67262,72704,"(38.033470000000001, -78.54974)"
Bedford city,Virginia,6222,42.9,4944,1337,2874,3348,"(38.066789999999997, -79.733099999999993)"
Bristol city,Virginia,17835,41.3,14128,3381,8388,9447,"(37.566800000000001, -79.783100000000005)"
Buena Vista city,Virginia,6650,37.6,5226,1068,3093,3557,"(37.550150000000002, -78.566389999999998)"
Charlottesville city,Virginia,43475,27.8,37001,4017,20754,22721,"(37.000149999999998, -78.683059999999998)"
Chesapeake city,Virginia,222209,37,164688,23146,108051,114158,"(37.000149999999998, -78.683059999999998)"
Colonial Heights city,Virginia,17411,41.9,13523,3418,8062,9349,"(39.116770000000002, -77.966390000000004)"
Covington city,Virginia,5961,42.9,4694,1116,2886,3075,"(39.116770000000002, -77.966390000000004)"
Danville city,Virginia,43055,42.6,33793,8215,19636,23419,"(37.500430000000001, -78.25)"
Emporia city,Virginia,5927,37.9,4400,1002,2730,3197,"(37.06682, -77.633049999999997)"
Fairfax city,Virginia,22565,39.1,17973,3088,11123,11442,"(37.950139999999998, -76.949690000000004)"
Falls Church city,Virginia,12332,39,9285,1293,6043,6289,"(38.850110000000001, -77.349710000000002)"
Franklin city,Virginia,8582,40.700000000000003,6536,1480,3821,4761,"(37.850140000000003, -78.266390000000001)"
Fredericksburg city,Virginia,24286,28.8,19507,2413,11144,13142,"(39.216769999999997, -78.249719999999996)"
Galax city,Virginia,7042,42.4,5498,1423,3315,3727,"(39.216769999999997, -78.249719999999996)"
Hampton city,Virginia,137436,35.5,106162,16856,65750,71686,"(36.750419999999998, -78.933070000000001)"
Harrisonburg city,Virginia,48914,22.7,41566,4033,22798,26116,"(37.750140000000002, -77.483040000000003)"
Hopewell city,Virginia,22591,36.5,16918,3359,10476,12115,"(38.366790000000002, -79.366429999999994)"
Lexington city,Virginia,7042,22.8,6328,1077,3923,3119,"(36.683419999999998, -83.133229999999998)"
Lynchburg city,Virginia,75568,30.3,60794,10556,35474,40094,"(36.950150000000001, -78.250280000000004)"
Manassas city,Virginia,37821,32.1,27074,2607,18967,18854,"(38.416789999999999, -78.266390000000001)"
Manassas Park city,Virginia,14273,30.9,10214,806,7242,7031,"(38.416789999999999, -78.266390000000001)"
Martinsville city,Virginia,13821,43.6,10866,2649,6293,7528,"(38.416789999999999, -78.266390000000001)"
Newport News city,Virginia,180719,32.299999999999997,136806,19219,87263,93456,"(37.48348, -76.999690000000001)"
Norfolk city,Virginia,242803,29.7,192191,22796,125797,117006,"(37.48348, -76.999690000000001)"
Norton city,Virginia,3958,40,3094,580,1824,2134,"(37.883470000000003, -76.416340000000005)"
Petersburg city,Virginia,32420,39.799999999999997,25713,4854,15147,17273,"(36.666800000000002, -80.283109999999994)"
Poquoson city,Virginia,12150,43.5,9181,1891,5997,6153,"(36.816809999999997, -79.399749999999997)"
Portsmouth city,Virginia,95535,35.700000000000003,72869,12619,45933,49602,"(36.816809999999997, -79.399749999999997)"
Radford city,Virginia,16408,22.4,14263,1382,7779,8629,"(37.066789999999997, -80.716459999999998)"
Richmond city,Virginia,204214,32,166205,22619,97331,106883,"(38.666789999999999, -78.149720000000002)"
Roanoke city,Virginia,97032,38.5,75906,13836,46390,50642,"(37.950130000000001, -76.733009999999993)"
Salem city,Virginia,24802,40.5,19868,4240,11767,13035,"(36.933439999999997, -82.083190000000002)"
Staunton city,Virginia,23746,42.2,19131,4690,10747,12999,"(38.416789999999999, -77.466369999999998)"
Suffolk city,Virginia,84585,37.9,62448,9727,40588,43997,"(38.416789999999999, -77.466369999999998)"
Virginia Beach city,Virginia,437994,34.9,332745,46435,214441,223553,"(37.100119999999997, -81.566500000000005)"
Waynesboro city,Virginia,21006,38.799999999999997,16110,3567,10006,11000,"(36.71678, -81.96651)"
Williamsburg city,Virginia,14068,23.8,12664,1879,6625,7443,"(38.116799999999998, -76.783019999999993)"
Winchester city,Virginia,26203,35.1,20382,3676,12898,13305,"(38.116799999999998, -76.783019999999993)"
Adams County,Washington,18728,29,12216,1915,9544,9184,"(46.983199999999997, -118.51776)"
Asotin County,Washington,21623,43.5,16919,4172,10453,11170,"(46.19988, -117.18433)"
Benton County,Washington,175177,35.6,127513,20586,87486,87691,"(46.26652, -119.48447)"
Chelan County,Washington,72453,39.299999999999997,54390,11175,36130,36323,"(47.883180000000003, -120.63454)"
Clallam County,Washington,71404,49,58415,17189,35429,35975,"(48.049810000000001, -123.83463999999999)"
Clark County,Washington,425363,36.700000000000003,312788,48710,209954,215409,"(45.799840000000003, -122.48454)"
Columbia County,Washington,4078,48.3,3255,937,2022,2056,"(46.299860000000002, -117.93438)"
Cowlitz County,Washington,102410,40.200000000000003,77689,15805,50542,51868,"(46.199829999999999, -122.68455)"
Douglas County,Washington,38431,36.799999999999997,27960,5443,19198,19233,"(47.716529999999999, -119.73448999999999)"
Ferry County,Washington,7551,47.3,6053,1428,3905,3646,"(48.466560000000001, -118.53446)"
Franklin County,Washington,78163,28.4,51449,5696,40447,37716,"(46.516530000000003, -118.93445)"
Garfield County,Washington,2266,49,1812,506,1118,1148,"(46.449869999999997, -117.55101999999999)"
Grant County,Washington,89120,32.1,61895,10531,45420,43700,"(47.149859999999997, -119.48448)"
Grays Harbor County,Washington,72797,41.9,57073,11849,37357,35440,"(47.083150000000003, -123.83461)"
Island County,Washington,78506,43.2,62212,14439,38857,39649,"(48.133150000000001, -122.58459999999999)"
Jefferson County,Washington,29872,53.9,25426,7842,14798,15074,"(47.616480000000003, -123.08461)"
King County,Washington,1931249,37.1,1517747,210679,962090,969159,"(47.46649, -121.81789000000001)"
Kitsap County,Washington,251133,39.4,194637,33296,127155,123978,"(47.616480000000003, -122.66792)"
Kittitas County,Washington,40915,31.9,33431,5212,20793,20122,"(47.116509999999998, -120.68452000000001)"
Klickitat County,Washington,20318,45.3,15835,3625,10268,10050,"(45.866509999999998, -120.76784000000001)"
Lewis County,Washington,75455,41.5,57995,13076,37750,37705,"(46.583159999999999, -122.40122)"
Lincoln County,Washington,10570,47.6,8174,2197,5277,5293,"(47.549869999999999, -118.48443)"
Mason County,Washington,60699,44.4,48325,11112,31400,29299,"(47.349809999999998, -123.1846)"
Okanogan County,Washington,41120,42.9,31453,7070,20750,20370,"(48.549869999999999, -119.73451)"
Pacific County,Washington,20920,50.8,17172,5183,10488,10432,"(46.566490000000002, -123.71794)"
Pend Oreille County,Washington,13001,47.8,10193,2485,6593,6408,"(48.533239999999999, -117.28439)"
Pierce County,Washington,795225,35.9,597098,87785,392934,402291,"(47.033160000000002, -122.11789)"
San Juan County,Washington,15769,52.7,13276,3657,7665,8104,"(48.566490000000002, -122.96796000000001)"
Skagit County,Washington,116901,40.1,89164,18876,57980,58921,"(48.466500000000003, -121.78458000000001)"
Skamania County,Washington,11066,44,8608,1596,5565,5501,"(46.033169999999998, -121.9012)"
Snohomish County,Washington,713335,37.1,539168,73544,356958,356377,"(48.04983, -121.7179)"
Spokane County,Washington,471221,36.799999999999997,361719,60969,232696,238525,"(47.61656, -117.36771)"
Stevens County,Washington,43531,45,33036,7516,21782,21749,"(48.433230000000002, -117.83441999999999)"
Thurston County,Washington,252264,38.5,194142,32764,122952,129312,"(46.916490000000003, -122.81791)"
Wahkiakum County,Washington,3978,52.3,3244,1015,1999,1979,"(46.283160000000002, -123.43458)"
Walla Walla County,Washington,58781,36.700000000000003,45541,8778,29835,28946,"(46.283189999999998, -118.48442)"
Whatcom County,Washington,201140,36.6,158935,26640,99635,101505,"(48.916510000000002, -121.78458999999999)"
Whitman County,Washington,44776,24.4,38035,4257,22806,21970,"(46.916550000000001, -117.48436)"
Yakima County,Washington,243231,32.200000000000003,169193,28122,121676,121555,"(46.46651, -120.66785)"
Barbour County,West Virginia,16589,41.5,12987,2761,8190,8399,"(39.133429999999997, -80.033140000000003)"
Berkeley County,West Virginia,104169,37.6,77953,11858,51703,52466,"(39.450099999999999, -78.033060000000006)"
Boone County,West Virginia,24629,40.700000000000003,19004,3489,12239,12390,"(38.016770000000001, -81.699839999999995)"
Braxton County,West Virginia,14523,43.8,11514,2546,7316,7207,"(38.716769999999997, -80.699820000000003)"
Brooke County,West Virginia,24069,44.8,19492,4602,11672,12397,"(40.2834, -80.566460000000006)"
Cabell County,West Virginia,96319,38.700000000000003,77411,15364,46972,49347,"(38.433419999999998, -82.249870000000001)"
Calhoun County,West Virginia,7627,45.1,6113,1385,3821,3806,"(38.833419999999997, -81.116500000000002)"
Clay County,West Virginia,9386,41.5,7167,1472,4664,4722,"(38.483429999999998, -81.066500000000005)"
Doddridge County,West Virginia,8202,42.4,6526,1329,4391,3811,"(39.266750000000002, -80.699820000000003)"
Fayette County,West Virginia,46039,43,36583,7802,23085,22954,"(38.050109999999997, -81.099819999999994)"
Gilmer County,West Virginia,8693,38,7436,1193,5256,3437,"(38.933419999999998, -80.849829999999997)"
Grant County,West Virginia,11937,44,9380,2189,5928,6009,"(39.116770000000002, -79.199759999999998)"
Greenbrier County,West Virginia,35480,45,28364,6838,17296,18184,"(37.950119999999998, -80.416470000000004)"
Hampshire County,West Virginia,23964,42.6,18578,3898,12136,11828,"(39.33343, -78.599729999999994)"
Hancock County,West Virginia,30676,45.3,24515,5754,14841,15835,"(40.500619999999998, -80.566460000000006)"
Hardy County,West Virginia,14025,42.8,11016,2329,7078,6947,"(39.016779999999997, -78.816410000000005)"
Harrison County,West Virginia,69099,41.8,53927,11408,33648,35451,"(39.28342, -80.383150000000001)"
Jackson County,West Virginia,29211,42.2,22622,5165,14425,14786,"(38.833419999999997, -81.683179999999993)"
Jefferson County,West Virginia,53498,38.9,40794,6314,26444,27054,"(39.3001, -77.849720000000005)"
Kanawha County,West Virginia,193063,42.4,153329,32315,92725,100338,"(38.33343, -81.566509999999994)"
Lewis County,West Virginia,16372,43.4,12975,2928,8068,8304,"(38.966760000000001, -80.516480000000001)"
Lincoln County,West Virginia,21720,41.2,16790,3285,10803,10917,"(38.166759999999996, -82.083190000000002)"
Logan County,West Virginia,36743,42.4,29249,5575,18098,18645,"(37.833440000000003, -81.933179999999993)"
McDowell County,West Virginia,22113,43.8,17699,3658,10937,11176,"(37.366779999999999, -81.649829999999994)"
Marion County,West Virginia,56418,41,45213,9541,27546,28872,"(39.516750000000002, -80.249799999999993)"
Marshall County,West Virginia,33107,44.3,26215,5814,16154,16953,"(39.86674, -80.649799999999999)"
Mason County,West Virginia,27324,42.4,21392,4654,13131,14193,"(38.800080000000001, -82.000140000000002)"
Mercer County,West Virginia,62264,42.5,49472,11213,29754,32510,"(37.400120000000001, -81.116479999999996)"
Mineral County,West Virginia,28212,42.3,22341,4893,13986,14226,"(39.400100000000002, -78.949749999999995)"
Mingo County,West Virginia,26839,40.9,20923,3623,13160,13679,"(37.700099999999999, -82.149860000000004)"
Monongalia County,West Virginia,96189,29.1,80937,9826,49600,46589,"(39.650080000000003, -80.033119999999997)"
Monroe County,West Virginia,13502,45,10664,2651,6680,6822,"(37.566789999999997, -80.549790000000002)"
Morgan County,West Virginia,17541,45,13941,3216,8749,8792,"(39.566760000000002, -78.250010000000003)"
Nicholas County,West Virginia,26233,43.3,20683,4477,12914,13319,"(38.300109999999997, -80.833150000000003)"
Ohio County,West Virginia,44443,43.5,35978,8213,21165,23278,"(40.100070000000002, -80.616460000000004)"
Pendleton County,West Virginia,7695,47.3,6232,1681,3897,3798,"(38.683450000000001, -79.349770000000007)"
Pleasants County,West Virginia,7605,42.4,6054,1228,4079,3526,"(39.36674, -81.149829999999994)"
Pocahontas County,West Virginia,8719,47.1,7159,1684,4473,4246,"(38.316789999999997, -80.033119999999997)"
Preston County,West Virginia,33520,42,26968,5257,17298,16222,"(39.466760000000001, -79.666439999999994)"
Putnam County,West Virginia,55486,40.9,42362,7977,27249,28237,"(38.516759999999998, -81.883189999999999)"
Raleigh County,West Virginia,78859,41.1,62479,12661,39387,39472,"(37.750109999999999, -81.24982)"
Randolph County,West Virginia,29405,43.4,23699,5246,15148,14257,"(38.766779999999997, -79.833119999999994)"
Ritchie County,West Virginia,10449,44.3,8241,1797,5222,5227,"(39.16675, -81.083169999999996)"
Roane County,West Virginia,14926,43.5,11689,2566,7384,7542,"(38.733420000000002, -81.34984)"
Summers County,West Virginia,13927,45.7,11404,2682,6250,7677,"(37.650120000000001, -80.866470000000007)"
Taylor County,West Virginia,16895,42.3,13381,2744,8549,8346,"(39.350090000000002, -80.049800000000005)"
Tucker County,West Virginia,7141,46.3,5771,1501,3579,3562,"(39.100110000000001, -79.566450000000003)"
Tyler County,West Virginia,9208,45.2,7283,1700,4513,4695,"(39.45008, -80.866500000000002)"
Upshur County,West Virginia,24254,40.9,19250,4044,11944,12310,"(38.883429999999997, -80.250360000000001)"
Wayne County,West Virginia,42481,41.3,32959,7014,20744,21737,"(38.150089999999999, -82.449870000000004)"
Webster County,West Virginia,9154,44.1,7180,1604,4531,4623,"(38.516770000000001, -80.416470000000004)"
Wetzel County,West Virginia,16583,44.8,13119,3239,8139,8444,"(39.583410000000001, -80.666480000000007)"
Wirt County,West Virginia,5717,44.4,4516,894,2868,2849,"(39.033410000000003, -81.34984)"
Wood County,West Virginia,86956,42.2,67965,14718,41947,45009,"(39.20008, -81.501230000000007)"
Wyoming County,West Virginia,23796,42.6,18682,3589,11810,11986,"(37.616779999999999, -81.54983)"
Adams County,Wisconsin,20875,49.2,17454,4899,11221,9654,"(43.933309999999999, -89.76679)"
Ashland County,Wisconsin,16157,40.299999999999997,12413,2567,8082,8075,"(46.399949999999997, -90.833519999999993)"
Barron County,Wisconsin,45870,43.1,35720,8348,22814,23056,"(45.416620000000002, -91.850170000000006)"
Bayfield County,Wisconsin,15014,49.4,12161,3112,7716,7298,"(46.549939999999999, -91.150189999999995)"
Brown County,Wisconsin,248007,36.200000000000003,186184,28789,122658,125349,"(44.466659999999997, -87.966769999999997)"
Buffalo County,Wisconsin,13587,44.1,10566,2459,6859,6728,"(44.366630000000001, -91.78349)"
Burnett County,Wisconsin,15457,49.1,12375,3569,7806,7651,"(45.84995, -92.383529999999993)"
Calumet County,Wisconsin,48971,38.4,35733,5625,24543,24428,"(44.083320000000001, -88.200100000000006)"
Chippewa County,Wisconsin,62415,40.1,47706,8935,32404,30011,"(45.066630000000004, -91.266819999999996)"
Clark County,Wisconsin,34690,37.200000000000003,24599,5413,17577,17113,"(44.7333, -90.633480000000006)"
Columbia County,Wisconsin,56833,41,43566,8294,28935,27898,"(43.466650000000001, -89.333449999999999)"
Crawford County,Wisconsin,16644,44.7,12920,3062,8575,8069,"(43.250540000000001, -90.916790000000006)"
Dane County,Wisconsin,488073,34.4,381989,50144,241411,246662,"(43.066659999999999, -89.433449999999993)"
Dodge County,Wisconsin,88759,40.700000000000003,69180,13251,46679,42080,"(43.41666, -88.700100000000006)"
Door County,Wisconsin,27785,49.4,22709,6245,13679,14106,"(44.91666, -87.3001)"
Douglas County,Wisconsin,44159,39.799999999999997,34694,6361,22087,22072,"(46.43327, -91.900189999999995)"
Dunn County,Wisconsin,43857,33.5,34798,5323,22133,21724,"(44.949959999999997, -91.883510000000001)"
Eau Claire County,Wisconsin,98736,33.4,77864,12435,48351,50385,"(44.733289999999997, -91.300160000000005)"
Florence County,Wisconsin,4423,49,3649,931,2262,2161,"(45.849960000000003, -88.366799999999998)"
Fond du Lac County,Wisconsin,101633,40.200000000000003,78589,15225,49926,51707,"(43.750540000000001, -88.466769999999997)"
Forest County,Wisconsin,9304,44.1,7261,1888,4724,4580,"(45.616630000000001, -88.783450000000002)"
Grant County,Wisconsin,51208,36.4,40322,7974,26636,24572,"(42.866660000000003, -90.700130000000001)"
Green County,Wisconsin,36842,41.1,27889,5497,18241,18601,"(42.83334, -89.600120000000004)"
Green Lake County,Wisconsin,19051,44.5,14663,3652,9509,9542,"(43.799979999999998, -89.033450000000002)"
Iowa County,Wisconsin,23687,41.1,17798,3269,11878,11809,"(43.000549999999997, -90.150120000000001)"
Iron County,Wisconsin,5916,51,4935,1502,2959,2957,"(46.250500000000002, -90.233509999999995)"
Jackson County,Wisconsin,20449,41.4,15818,3303,10874,9575,"(44.333289999999998, -90.866810000000001)"
Jefferson County,Wisconsin,83686,38.200000000000003,63829,11042,41638,42048,"(43.033340000000003, -88.766769999999994)"
Juneau County,Wisconsin,26664,43.6,20991,4677,14029,12635,"(43.916640000000001, -90.133459999999999)"
Kenosha County,Wisconsin,166426,36.299999999999997,123597,18679,82444,83982,"(42.566690000000001, -88.050079999999994)"
Kewaunee County,Wisconsin,20574,42.2,15725,3393,10460,10114,"(44.516660000000002, -87.633420000000001)"
La Crosse County,Wisconsin,114638,35.200000000000003,90176,15201,55961,58677,"(43.750520000000002, -91.100129999999993)"
Lafayette County,Wisconsin,16836,40.4,12487,2601,8582,8254,"(42.666670000000003, -90.133459999999999)"
Langlade County,Wisconsin,19977,45.7,15762,3986,10032,9945,"(45.250520000000002, -89.050110000000004)"
Lincoln County,Wisconsin,28743,44.7,22441,5269,14412,14331,"(45.316630000000004, -89.750690000000006)"
Manitowoc County,Wisconsin,81442,43,63232,13714,40489,40953,"(44.066659999999999, -87.800089999999997)"
Marathon County,Wisconsin,134063,39.4,101194,18988,67308,66755,"(44.899970000000003, -89.76679)"
Marinette County,Wisconsin,41749,45.7,33182,8254,20758,20991,"(45.366639999999997, -88.066779999999994)"
Marquette County,Wisconsin,15404,47.4,12319,3246,7808,7596,"(43.81664, -89.400120000000001)"
Menominee County,Wisconsin,4232,31.4,2853,482,2098,2134,"(45.000540000000001, -88.66677)"
Milwaukee County,Wisconsin,947735,33.6,711358,109133,457717,490018,"(43.000570000000003, -87.966750000000005)"
Monroe County,Wisconsin,44673,39.1,33003,6223,22648,22025,"(43.933300000000003, -90.616799999999998)"
Oconto County,Wisconsin,37660,43.7,29228,6022,19194,18466,"(45.000540000000001, -88.183430000000001)"
Oneida County,Wisconsin,35998,48,29359,7800,17993,18005,"(45.666620000000002, -89.500690000000006)"
Outagamie County,Wisconsin,176695,37.1,132271,20834,88130,88565,"(44.416649999999997, -88.466769999999997)"
Ozaukee County,Wisconsin,86395,42.9,66023,13208,42340,44055,"(43.383339999999997, -87.950090000000003)"
Pepin County,Wisconsin,7469,44.1,5765,1337,3780,3689,"(44.599969999999999, -92.050169999999994)"
Pierce County,Wisconsin,41019,34.5,31860,4283,20420,20599,"(44.7333, -92.433520000000001)"
Polk County,Wisconsin,44205,42.5,33705,7064,22177,22028,"(45.449959999999997, -92.41686)"
Portage County,Wisconsin,70019,35.799999999999997,55472,8955,34984,35035,"(44.466639999999998, -89.50067)"
Price County,Wisconsin,14159,48.3,11460,2968,7180,6979,"(45.68329, -90.350149999999999)"
Racine County,Wisconsin,195408,39,146898,25739,96771,98637,"(42.749459999999999, -88.075090000000003)"
Richland County,Wisconsin,18021,43,13821,3245,9042,8979,"(43.383310000000002, -90.433459999999997)"
Rock County,Wisconsin,160331,38,120148,21759,78815,81516,"(42.666679999999999, -89.066779999999994)"
Rusk County,Wisconsin,14755,45.8,11440,2964,7371,7384,"(45.466630000000002, -91.166820000000001)"
St. Croix County,Wisconsin,84345,36.700000000000003,61462,8468,42218,42127,"(43.733330000000002, -87.933430000000001)"
Sauk County,Wisconsin,61976,40,47209,9288,30848,31128,"(43.449979999999996, -89.950130000000001)"
Sawyer County,Wisconsin,16557,47.2,13103,3429,8393,8164,"(45.866619999999998, -91.233500000000006)"
Shawano County,Wisconsin,41949,43,32387,7680,20921,21028,"(44.799979999999998, -88.766769999999994)"
Sheboygan County,Wisconsin,115507,40.299999999999997,87925,16821,58010,57497,"(43.733330000000002, -87.933430000000001)"
Taylor County,Wisconsin,20689,41.8,15600,3334,10559,10130,"(45.216639999999998, -90.516810000000007)"
Trempealeau County,Wisconsin,28816,40.799999999999997,21831,4567,14638,14178,"(44.316630000000004, -91.350160000000002)"
Vernon County,Wisconsin,29773,41.5,21895,4962,14854,14919,"(43.583309999999997, -90.850129999999993)"
Vilas County,Wisconsin,21430,50.7,17621,5556,10861,10569,"(46.06662, -89.466809999999995)"
Walworth County,Wisconsin,102228,38.1,78228,13757,51237,50991,"(42.666679999999999, -88.533429999999996)"
Washburn County,Wisconsin,15911,47.7,12679,3380,7924,7987,"(45.899949999999997, -91.783510000000007)"
Washington County,Wisconsin,131887,40.9,99510,17803,65393,66494,"(43.366669999999999, -88.233429999999998)"
Waukesha County,Wisconsin,389891,42,296081,55688,191355,198536,"(43.033340000000003, -88.300089999999997)"
Waupaca County,Wisconsin,52410,43.5,40540,9462,26447,25963,"(44.466650000000001, -88.983440000000002)"
Waushara County,Wisconsin,24496,46.2,19662,4883,12893,11603,"(44.116639999999997, -89.25067)"
Winnebago County,Wisconsin,166994,37.9,130862,22336,83952,83042,"(44.066650000000003, -88.650109999999998)"
Wood County,Wisconsin,74749,42.6,57745,12762,36777,37972,"(44.449959999999997, -90.050129999999996)"
Albany County,Wyoming,36299,26.8,30262,3166,18897,17402,"(41.666640000000001, -105.70055000000001)"
Big Horn County,Wyoming,11668,41.8,8655,2108,5882,5786,"(44.533290000000001, -108.08399)"
Campbell County,Wyoming,46133,31.9,33151,2616,24258,21875,"(44.250540000000001, -105.55056)"
Carbon County,Wyoming,15885,38.9,12134,2044,8553,7332,"(41.666629999999998, -106.83393)"
Converse County,Wyoming,13833,39,10321,1776,7017,6816,"(42.966630000000002, -105.53388)"
Crook County,Wyoming,7083,43.6,5394,1150,3648,3435,"(44.566650000000003, -104.56717999999999)"
Fremont County,Wyoming,40123,38.5,29911,5805,20030,20093,"(42.916629999999998, -108.66734)"
Goshen County,Wyoming,13249,43.6,10548,2500,6906,6343,"(42.083300000000001, -104.35051)"
Hot Springs County,Wyoming,4812,48.6,3848,1088,2377,2435,"(43.699959999999997, -108.46733)"
Johnson County,Wyoming,8569,44.8,6673,1588,4365,4204,"(44.03331, -106.56726)"
Laramie County,Wyoming,91738,37,69337,11505,45875,45863,"(41.349980000000002, -104.66719000000001)"
Lincoln County,Wyoming,18106,37.4,13002,2241,9302,8804,"(42.166600000000003, -110.6674)"
Natrona County,Wyoming,75450,36.799999999999997,57430,9392,37982,37468,"(42.966630000000002, -106.78394)"
Niobrara County,Wyoming,2484,46.1,2014,513,1159,1325,"(43.049970000000002, -104.48384)"
Park County,Wyoming,28205,43.6,22294,4942,14021,14184,"(44.416609999999999, -109.6674)"
Platte County,Wyoming,8667,47.5,6902,1797,4303,4364,"(42.133299999999998, -104.96719)"
Sheridan County,Wyoming,29116,41.9,22631,4548,14565,14551,"(44.833309999999997, -106.91728999999999)"
Sublette County,Wyoming,10247,38.299999999999997,7819,1039,5550,4697,"(42.699939999999998, -109.86736999999999)"
Sweetwater County,Wyoming,43806,32.799999999999997,31937,3643,22849,20957,"(41.666629999999998, -108.91734)"
Teton County,Wyoming,21294,36.9,17218,2098,11191,10103,"(43.916609999999999, -110.58410000000001)"
Uinta County,Wyoming,21118,33.9,14747,1874,10662,10456,"(41.262500000000003, -110.5684)"
Washakie County,Wyoming,8533,41.8,6361,1508,4255,4278,"(43.916629999999998, -107.58396999999999)"
Weston County,Wyoming,7208,42.3,5635,1149,3790,3418,"(43.849980000000002, -104.56717999999999)"
